/data0/juliano/homburg/alternative/50_Minutes-Colours.mp3.wav	alternative
/data0/juliano/homburg/alternative/50_Minutes-Nightwalk.mp3.wav	alternative
/data0/juliano/homburg/alternative/50_Minutes-The_Great_Wall.mp3.wav	alternative
/data0/juliano/homburg/alternative/Abigail_Lapell-Dress_Rehearsal.mp3.wav	alternative
/data0/juliano/homburg/alternative/Albino_Catfish-Ice_Cream.mp3.wav	alternative
/data0/juliano/homburg/alternative/Alex_Niedt-But_I_Love_You___.mp3.wav	alternative
/data0/juliano/homburg/alternative/Anders_Tengdahl-I_came_here_to_see_you.mp3.wav	alternative
/data0/juliano/homburg/alternative/Anders_Tengdahl-When_You_Cry.mp3.wav	alternative
/data0/juliano/homburg/alternative/Back_Bone_Shiver-Give_It_A_Name.mp3.wav	alternative
/data0/juliano/homburg/alternative/Back_Bone_Shiver-Insect.mp3.wav	alternative
/data0/juliano/homburg/alternative/Barton_Gill-Reach_Out__acoustic_.mp3.wav	alternative
/data0/juliano/homburg/alternative/Bondo-Just_Wanna_Get_Horny.mp3.wav	alternative
/data0/juliano/homburg/alternative/Cabrini-Winter_2000.mp3.wav	alternative
/data0/juliano/homburg/alternative/Chance_-Say_What_You_Will.mp3.wav	alternative
/data0/juliano/homburg/alternative/Circle_the_Square-CPU.mp3.wav	alternative
/data0/juliano/homburg/alternative/Common_Thrill-Morphine_Drip.mp3.wav	alternative
/data0/juliano/homburg/alternative/Denny_Porter-Where_to_Begin.mp3.wav	alternative
/data0/juliano/homburg/alternative/Dopamine-Tempermentally.mp3.wav	alternative
/data0/juliano/homburg/alternative/Emberglow-Back_At_You.mp3.wav	alternative
/data0/juliano/homburg/alternative/Fake_Gimms-Simple_Facts.mp3.wav	alternative
/data0/juliano/homburg/alternative/Fake_Gimms-The_Cell_Phone_Song.mp3.wav	alternative
/data0/juliano/homburg/alternative/Falling_Wallendas-Porcupine.mp3.wav	alternative
/data0/juliano/homburg/alternative/For_All_The_Drifters-Evening_Meets_The_Dawn.mp3.wav	alternative
/data0/juliano/homburg/alternative/Frank_and_Oliver_Trio-One_Day.mp3.wav	alternative
/data0/juliano/homburg/alternative/Greg_Walsh-Day_by_Day.mp3.wav	alternative
/data0/juliano/homburg/alternative/H_A_D_-Carpool.mp3.wav	alternative
/data0/juliano/homburg/alternative/H_A_D_-Policemen___Planes.mp3.wav	alternative
/data0/juliano/homburg/alternative/Halogen_canada__now__dead_leaves_-Somethings.mp3.wav	alternative
/data0/juliano/homburg/alternative/Happy_Medium-Misty_blue.mp3.wav	alternative
/data0/juliano/homburg/alternative/Ione_Skylab-Soak.mp3.wav	alternative
/data0/juliano/homburg/alternative/J_M_W_-New_Blues.mp3.wav	alternative
/data0/juliano/homburg/alternative/Jabudah-Infected.mp3.wav	alternative
/data0/juliano/homburg/alternative/Jamie_Stellini-Don_t_Worry_About_Me.mp3.wav	alternative
/data0/juliano/homburg/alternative/Jeff_Johnston-Being_There.mp3.wav	alternative
/data0/juliano/homburg/alternative/Kid_Chameleon-My_Heroin.mp3.wav	alternative
/data0/juliano/homburg/alternative/Kinematic-So_Green.mp3.wav	alternative
/data0/juliano/homburg/alternative/Kunek-Bright_Eyes__The_Swell.mp3.wav	alternative
/data0/juliano/homburg/alternative/Kunek-Good_Day.mp3.wav	alternative
/data0/juliano/homburg/alternative/Kunek-Section_2.mp3.wav	alternative
/data0/juliano/homburg/alternative/LEDASWAN-Over_Again.mp3.wav	alternative
/data0/juliano/homburg/alternative/Legendary_Juggernaut-Fallen.mp3.wav	alternative
/data0/juliano/homburg/alternative/Leisure_Alaska-In_Me.mp3.wav	alternative
/data0/juliano/homburg/alternative/Loomis-It_s_Too_Hard.mp3.wav	alternative
/data0/juliano/homburg/alternative/Loquat-Swingset_Chain.mp3.wav	alternative
/data0/juliano/homburg/alternative/Manic_Cure-You_Know.mp3.wav	alternative
/data0/juliano/homburg/alternative/Marcco-Today.mp3.wav	alternative
/data0/juliano/homburg/alternative/Mark_Schwaber-ghosting.mp3.wav	alternative
/data0/juliano/homburg/alternative/Matt_Monsoor-Ride.mp3.wav	alternative
/data0/juliano/homburg/alternative/Matthew_Long-Space_Cowboy.mp3.wav	alternative
/data0/juliano/homburg/alternative/Matthew_Walker-What_.mp3.wav	alternative
/data0/juliano/homburg/alternative/Mike_Hicks-You_re_Still_Lost.mp3.wav	alternative
/data0/juliano/homburg/alternative/Millbrook_Music-Crude_Model_of_You.mp3.wav	alternative
/data0/juliano/homburg/alternative/Mission_to_Mars-watery_grave.mp3.wav	alternative
/data0/juliano/homburg/alternative/Moto__formerly_Mildseven_-Size_Nine.mp3.wav	alternative
/data0/juliano/homburg/alternative/My_Favorite_Dancer-Hey_Abby__I_thought_this_was_a_different_bunk_.mp3.wav	alternative
/data0/juliano/homburg/alternative/New_Cartel-Wait_Forever.mp3.wav	alternative
/data0/juliano/homburg/alternative/Novatemp-Coming_Down.mp3.wav	alternative
/data0/juliano/homburg/alternative/Oscar_Trim-Strow.mp3.wav	alternative
/data0/juliano/homburg/alternative/Panel-435.mp3.wav	alternative
/data0/juliano/homburg/alternative/Peppermint_Stranger-No_Love.mp3.wav	alternative
/data0/juliano/homburg/alternative/Perfectly_Good_Airplanes-Kids_or_Animals.mp3.wav	alternative
/data0/juliano/homburg/alternative/Peter_Adams-Cementalisque.mp3.wav	alternative
/data0/juliano/homburg/alternative/Peter_Adams-Listen_Harmony.mp3.wav	alternative
/data0/juliano/homburg/alternative/Phideaux-fragment.mp3.wav	alternative
/data0/juliano/homburg/alternative/Poetica-Behind_the_door.mp3.wav	alternative
/data0/juliano/homburg/alternative/Purple_Wage-Daydream.mp3.wav	alternative
/data0/juliano/homburg/alternative/Pyramid_-Monster_in_the_Canyon.mp3.wav	alternative
/data0/juliano/homburg/alternative/Pyramid_-Streets_Were_Raining.mp3.wav	alternative
/data0/juliano/homburg/alternative/ROOMTONE-radio.mp3.wav	alternative
/data0/juliano/homburg/alternative/Remy_De_La_Mora-Ostrich.mp3.wav	alternative
/data0/juliano/homburg/alternative/Rick_Dobbelaer-Your_Skin.mp3.wav	alternative
/data0/juliano/homburg/alternative/SMOKESCREEN-California__2004_.mp3.wav	alternative
/data0/juliano/homburg/alternative/SMOKESCREEN-Don_t_Say.mp3.wav	alternative
/data0/juliano/homburg/alternative/SMOKESCREEN-Parallel.mp3.wav	alternative
/data0/juliano/homburg/alternative/SMOKESCREEN-Wasting_Away.mp3.wav	alternative
/data0/juliano/homburg/alternative/Sarah_Fimm-red_paper_bag.mp3.wav	alternative
/data0/juliano/homburg/alternative/Sean_Moore-Soliloquy.mp3.wav	alternative
/data0/juliano/homburg/alternative/Secret_Girl-Human_Exhibit.mp3.wav	alternative
/data0/juliano/homburg/alternative/Secret_Suburbia-White_Flight.mp3.wav	alternative
/data0/juliano/homburg/alternative/Secret_Suburbia-_The_Ghost_Of__Santa_Fe.mp3.wav	alternative
/data0/juliano/homburg/alternative/Sheldon_Kelly-Branding_Cows__No_Use_To_Me_.mp3.wav	alternative
/data0/juliano/homburg/alternative/Shortwave_Radio-Cardiac.mp3.wav	alternative
/data0/juliano/homburg/alternative/Stara_Zagora-luster.mp3.wav	alternative
/data0/juliano/homburg/alternative/Sugarplum_Fairies-_2_Kraft_Paperbag.mp3.wav	alternative
/data0/juliano/homburg/alternative/Sugarplum_Fairies-sugarfree.mp3.wav	alternative
/data0/juliano/homburg/alternative/Sugarplum_Fairies-the_state_we_re_in.mp3.wav	alternative
/data0/juliano/homburg/alternative/T_minus_Band-2084.mp3.wav	alternative
/data0/juliano/homburg/alternative/Ted_McCloskey-wish_you_were_there.mp3.wav	alternative
/data0/juliano/homburg/alternative/The_Beeps-tell_me.mp3.wav	alternative
/data0/juliano/homburg/alternative/The_Curtain_Society-Marigold_Girl.mp3.wav	alternative
/data0/juliano/homburg/alternative/The_D_A_s-Taxis_And_Trains.mp3.wav	alternative
/data0/juliano/homburg/alternative/The_Golden_Sounds-Jaded_Robots.mp3.wav	alternative
/data0/juliano/homburg/alternative/The_Golden_Sounds-whistles_and_windchimes.mp3.wav	alternative
/data0/juliano/homburg/alternative/The_Mercury_Stars-Just_Below_The_Surface_Lies_Something_Thicker_Than.mp3.wav	alternative
/data0/juliano/homburg/alternative/The_Milwaukees-Drink_Soviet_Champagne.mp3.wav	alternative
/data0/juliano/homburg/alternative/The_Rantings_of_EVA-Infrared.mp3.wav	alternative
/data0/juliano/homburg/alternative/The_Rosewood_Fall-Driving_Salinas.mp3.wav	alternative
/data0/juliano/homburg/alternative/The_Rubber_Maids-Mr__Moustache.mp3.wav	alternative
/data0/juliano/homburg/alternative/The_Shiva_Furnace-Miza.mp3.wav	alternative
/data0/juliano/homburg/alternative/The_Sudden_Recovery-Consign.mp3.wav	alternative
/data0/juliano/homburg/alternative/The_Sudden_Recovery-My_Song.mp3.wav	alternative
/data0/juliano/homburg/alternative/The_Vision_of_a_Dying_World-We_re_Not_Afraid_of_Silence.mp3.wav	alternative
/data0/juliano/homburg/alternative/Tom_Marshall___Co-Appreciate.mp3.wav	alternative
/data0/juliano/homburg/alternative/Tom_McAteer-Selfish_Goodbye.mp3.wav	alternative
/data0/juliano/homburg/alternative/Tubby-Dark_Road.mp3.wav	alternative
/data0/juliano/homburg/alternative/Velasco-Calma.mp3.wav	alternative
/data0/juliano/homburg/alternative/Very_Large_Array-magnified.mp3.wav	alternative
/data0/juliano/homburg/alternative/Windermere-Trailer_Park.mp3.wav	alternative
/data0/juliano/homburg/alternative/Windsor_Bellephone-Get_Back_My_Shine.mp3.wav	alternative
/data0/juliano/homburg/alternative/Wisermind-Drama_King.mp3.wav	alternative
/data0/juliano/homburg/alternative/Woody-Sandwitch.mp3.wav	alternative
/data0/juliano/homburg/alternative/Zach_Madden-Kid.mp3.wav	alternative
/data0/juliano/homburg/alternative/Zach_Madden-Scribbledown.mp3.wav	alternative
/data0/juliano/homburg/alternative/___In_the_Dirty_City-Longtooth.mp3.wav	alternative
/data0/juliano/homburg/alternative/bluestarbaby-all_i_need.mp3.wav	alternative
/data0/juliano/homburg/alternative/cellophane_rain-orchid.mp3.wav	alternative
/data0/juliano/homburg/alternative/dallas_orbiter-Bed_of_Stars.mp3.wav	alternative
/data0/juliano/homburg/alternative/dave_keegan-Do_That_Again.mp3.wav	alternative
/data0/juliano/homburg/alternative/dave_keegan-Seven_Years.mp3.wav	alternative
/data0/juliano/homburg/alternative/dig_for_fire-that_s_all.mp3.wav	alternative
/data0/juliano/homburg/alternative/docter-favorite_record.mp3.wav	alternative
/data0/juliano/homburg/alternative/fearless_juan-Glow.mp3.wav	alternative
/data0/juliano/homburg/alternative/flying_virgins-tahoe_morning_diner.mp3.wav	alternative
/data0/juliano/homburg/alternative/hayes-Asinimaha.mp3.wav	alternative
/data0/juliano/homburg/alternative/hostmom-it_s_close_up_far_away.mp3.wav	alternative
/data0/juliano/homburg/alternative/hostmom-supply_and_demand.mp3.wav	alternative
/data0/juliano/homburg/alternative/hotpipes-The_Fatal_Egg.mp3.wav	alternative
/data0/juliano/homburg/alternative/kite-as_worlds_collide.mp3.wav	alternative
/data0/juliano/homburg/alternative/laura_distasi-moonsong.mp3.wav	alternative
/data0/juliano/homburg/alternative/manifold-room_22.mp3.wav	alternative
/data0/juliano/homburg/alternative/manifold-setting.mp3.wav	alternative
/data0/juliano/homburg/alternative/nothot-I_Feel_Better_Already.mp3.wav	alternative
/data0/juliano/homburg/alternative/number_99-common_DEMO.mp3.wav	alternative
/data0/juliano/homburg/alternative/pilot_round_the_sun-hadwehad.mp3.wav	alternative
/data0/juliano/homburg/alternative/revlover-without_ocean.mp3.wav	alternative
/data0/juliano/homburg/alternative/rick_temporao-maniac.mp3.wav	alternative
/data0/juliano/homburg/alternative/rm__101-half_of_what_you_wanted.mp3.wav	alternative
/data0/juliano/homburg/alternative/rm__101-straight_line.mp3.wav	alternative
/data0/juliano/homburg/alternative/stars_of_stage_and_screen-silver_memories.mp3.wav	alternative
/data0/juliano/homburg/alternative/stars_of_stage_and_screen-starlight.mp3.wav	alternative
/data0/juliano/homburg/alternative/stereogirl-true_what_they_say.mp3.wav	alternative
/data0/juliano/homburg/alternative/steve_hefter-cure_for_sadness.mp3.wav	alternative
/data0/juliano/homburg/alternative/the_albacore_pageant-your_beautiful_way.mp3.wav	alternative
/data0/juliano/homburg/alternative/tingler-New_York.mp3.wav	alternative
/data0/juliano/homburg/alternative/via_audio-developing_active_people.mp3.wav	alternative
/data0/juliano/homburg/blues/All_Men_Are_Dogs_-GIGOLETTE.mp3.wav	blues
/data0/juliano/homburg/blues/All_Men_Are_Dogs_-I_M_LOOKING_FOR_MY_HUSBAND_.mp3.wav	blues
/data0/juliano/homburg/blues/Andy_Kimbel-Red_Hot_Blues.mp3.wav	blues
/data0/juliano/homburg/blues/BB_CHUNG_KING_AND_THE_BUDDAHEADS-COMPANY_GRAVEYARD.mp3.wav	blues
/data0/juliano/homburg/blues/BB_CHUNG_KING_AND_THE_BUDDAHEADS-LITTLE_GIRL.mp3.wav	blues
/data0/juliano/homburg/blues/BB_CHUNG_KING_AND_THE_BUDDAHEADS-rise_above_it.mp3.wav	blues
/data0/juliano/homburg/blues/Bernie_Clarke_and_the_Rhythm_Sharks-Love_Recession.mp3.wav	blues
/data0/juliano/homburg/blues/Bernie_Clarke_and_the_Rhythm_Sharks-Married_Man.mp3.wav	blues
/data0/juliano/homburg/blues/Big_American_Gurus-Good_to_be_a_Hard_Man.mp3.wav	blues
/data0/juliano/homburg/blues/Big_Hammer-Just_A_Fool.mp3.wav	blues
/data0/juliano/homburg/blues/Big_Steve___the_Trainwreck-Sorry_.mp3.wav	blues
/data0/juliano/homburg/blues/Big_Steve___the_Trainwreck-That_Train.mp3.wav	blues
/data0/juliano/homburg/blues/Billy_Marquis-black_and_white.mp3.wav	blues
/data0/juliano/homburg/blues/Billy_Marquis-dust_me_off.mp3.wav	blues
/data0/juliano/homburg/blues/Blue_Steele-We_re_Gonna_Move.mp3.wav	blues
/data0/juliano/homburg/blues/Bobby_Manriquez-How_We_Start.mp3.wav	blues
/data0/juliano/homburg/blues/Chicago_Kingsnakes-Get_Out_Of_Memphis.mp3.wav	blues
/data0/juliano/homburg/blues/Chumslick_Nick_and_the_Sharks-Didn_t_know_she_was_married.mp3.wav	blues
/data0/juliano/homburg/blues/Chumslick_Nick_and_the_Sharks-Married_to_the_Blues.mp3.wav	blues
/data0/juliano/homburg/blues/Chumslick_Nick_and_the_Sharks-Shark_Bite.mp3.wav	blues
/data0/juliano/homburg/blues/Circe_Link-Travelin__Daddy.mp3.wav	blues
/data0/juliano/homburg/blues/Claudette_King-Dust_Pan_Woman.mp3.wav	blues
/data0/juliano/homburg/blues/Creature_of_Mercy-Wounded.mp3.wav	blues
/data0/juliano/homburg/blues/DEALER-LITTLE_BLACK_BOOK.mp3.wav	blues
/data0/juliano/homburg/blues/Dale_Jackson_Band-HAVE_ANYBODY_SEEN_MY_MONEY.mp3.wav	blues
/data0/juliano/homburg/blues/Dale_Jackson_Band-Not_One_Soul_Told_Me.mp3.wav	blues
/data0/juliano/homburg/blues/Danny_Rhodes_and_the_Messengers-Two_Tons_of_Love.mp3.wav	blues
/data0/juliano/homburg/blues/David_Rotundo_and_the_Blue_Canadians-Butt_Bustin__Boogie.mp3.wav	blues
/data0/juliano/homburg/blues/Eastsouthern-Louisiana.mp3.wav	blues
/data0/juliano/homburg/blues/Enos_Hornet-Party_Time_.mp3.wav	blues
/data0/juliano/homburg/blues/Funky_Blues_Messiahs-Uptown_Groove.mp3.wav	blues
/data0/juliano/homburg/blues/Funky_Blues_Messiahs-Way_too_Funky.mp3.wav	blues
/data0/juliano/homburg/blues/Good_bye_Blue_Monday-I_ll_Be_By_Your_Side.mp3.wav	blues
/data0/juliano/homburg/blues/Good_bye_Blue_Monday-Look_Down_On_Me.mp3.wav	blues
/data0/juliano/homburg/blues/Good_bye_Blue_Monday-You_Give_Me_Strength.mp3.wav	blues
/data0/juliano/homburg/blues/Gregory_Morris_Group-Bay_Light_Lullaby.mp3.wav	blues
/data0/juliano/homburg/blues/Guitarboy-TWICE_A_DAY.mp3.wav	blues
/data0/juliano/homburg/blues/Guitarboy-Two_Tone_Blues.mp3.wav	blues
/data0/juliano/homburg/blues/Hard_Bargain-It_s_My_Time.mp3.wav	blues
/data0/juliano/homburg/blues/Henry_Correy___The_Correydors-Early_Mornin__Hours.mp3.wav	blues
/data0/juliano/homburg/blues/Jaded_Soul-Romeo.mp3.wav	blues
/data0/juliano/homburg/blues/Janet_Ryan_and_Straight_Up_-Cool_your_Engine.mp3.wav	blues
/data0/juliano/homburg/blues/Janet_Ryan_and_Straight_Up_-Love_Has_Left__The_Building_.mp3.wav	blues
/data0/juliano/homburg/blues/Janet_Ryan_and_Straight_Up_-No_Good_News.mp3.wav	blues
/data0/juliano/homburg/blues/Janet_Ryan_and_Straight_Up_-Take_your_Shoes_Off.mp3.wav	blues
/data0/juliano/homburg/blues/Janet_Ryan_and_Straight_Up_-Tired_of_Talking.mp3.wav	blues
/data0/juliano/homburg/blues/Joe_White-I_Won_tGo_Back.mp3.wav	blues
/data0/juliano/homburg/blues/Kalamazoo_Allstars-Day_Job_Blues.mp3.wav	blues
/data0/juliano/homburg/blues/Kelly_Bell_Band-Talkin__In_Your_Sleep.mp3.wav	blues
/data0/juliano/homburg/blues/KingRobbie-All_TiedUp.mp3.wav	blues
/data0/juliano/homburg/blues/KingRobbie-Classic_Case_Of_The_Blues.mp3.wav	blues
/data0/juliano/homburg/blues/KingRobbie-Last_Night.mp3.wav	blues
/data0/juliano/homburg/blues/Lightning_John-Killin__Spree_Blues.mp3.wav	blues
/data0/juliano/homburg/blues/Lil_Bob___the_Lollipops-You_Know_It_Ain_t_Right.mp3.wav	blues
/data0/juliano/homburg/blues/Loren_Schulte-Boom_Boom.mp3.wav	blues
/data0/juliano/homburg/blues/Los_Blancos-Mighty_Mean_Mama.mp3.wav	blues
/data0/juliano/homburg/blues/Los_Blancos-Shakin__That_Thing.mp3.wav	blues
/data0/juliano/homburg/blues/Man_Skinny-Bad_News.mp3.wav	blues
/data0/juliano/homburg/blues/Mark_David_Group-Dream_Outfit.mp3.wav	blues
/data0/juliano/homburg/blues/Mark_David_Group-Thunderbird.mp3.wav	blues
/data0/juliano/homburg/blues/Memphis_P__Tails-It_Ain_t_Easy.mp3.wav	blues
/data0/juliano/homburg/blues/Most_Wanted_Band-Mystery.mp3.wav	blues
/data0/juliano/homburg/blues/Murphy_s_Garage-Don_t_Call_Me_Sugar.mp3.wav	blues
/data0/juliano/homburg/blues/Naked_Soul_featuring_Jayar-Burnin__Bridges__Tumblin__Down_.mp3.wav	blues
/data0/juliano/homburg/blues/Nobby_Reed_Project-At_The_Bottom_Live.mp3.wav	blues
/data0/juliano/homburg/blues/Nobby_Reed_Project-Cryin__In_My_Dreams.mp3.wav	blues
/data0/juliano/homburg/blues/Nobby_Reed_Project-Good_Times_Live.mp3.wav	blues
/data0/juliano/homburg/blues/Nobby_Reed_Project-Have_You_Heard.mp3.wav	blues
/data0/juliano/homburg/blues/Nobby_Reed_Project-blues_bug__2.mp3.wav	blues
/data0/juliano/homburg/blues/Oreo_Blue-Look_At_Me.mp3.wav	blues
/data0/juliano/homburg/blues/Pardon_Me-_I_m__Going_Home.mp3.wav	blues
/data0/juliano/homburg/blues/Rebel_Storm-Gals_From_Mississippi.mp3.wav	blues
/data0/juliano/homburg/blues/Rebel_Storm-Standin__In_The_Rain.mp3.wav	blues
/data0/juliano/homburg/blues/Robin_Barrett-Da_Bomb_In_a_Backseat.mp3.wav	blues
/data0/juliano/homburg/blues/Rockin__Jake_Band-Bad_Mouth.mp3.wav	blues
/data0/juliano/homburg/blues/Slim_Pickens-Who_Cares.mp3.wav	blues
/data0/juliano/homburg/blues/Steve_Pierson-Secrets.mp3.wav	blues
/data0/juliano/homburg/blues/Suspects-Wonderful_Terrible_Thing.mp3.wav	blues
/data0/juliano/homburg/blues/Ted_McCloskey-let_me_go_or_let_me_in.mp3.wav	blues
/data0/juliano/homburg/blues/The_Blue_Olives-ripe.mp3.wav	blues
/data0/juliano/homburg/blues/The_Blues_Persuaders-Stare_Off_and_Mumble.mp3.wav	blues
/data0/juliano/homburg/blues/The_Blues_Persuaders-Summertime_Strut.mp3.wav	blues
/data0/juliano/homburg/blues/The_Curbfinders-Texas_Shuffle.mp3.wav	blues
/data0/juliano/homburg/blues/The_Fabulous_House_Rockers-Five_O_Clock_In_The_Mornin_.mp3.wav	blues
/data0/juliano/homburg/blues/The_Griswolds-The_Later_It_GEts__The_Better_I_Feel.mp3.wav	blues
/data0/juliano/homburg/blues/The_Guzzlers-When_I_Hold_You.mp3.wav	blues
/data0/juliano/homburg/blues/The_Hitman_Blues_Band-Busted.mp3.wav	blues
/data0/juliano/homburg/blues/The_Kelly_Richey_Band-My_Baby_s_Gone_Crazy.mp3.wav	blues
/data0/juliano/homburg/blues/The_Kelly_Richey_Band-The_Blues_Don_t_Lie.mp3.wav	blues
/data0/juliano/homburg/blues/The_Mitchell_Blues_Band-I_Don_t_Want_You_Anymore.mp3.wav	blues
/data0/juliano/homburg/blues/The_Oscar_Jordan_Band-Mister_Bad_Luck.mp3.wav	blues
/data0/juliano/homburg/blues/The_Paul_Wood_Band__formerly_The_Bridgeburners-Cryin__Won_t_Help_Ya.mp3.wav	blues
/data0/juliano/homburg/blues/The_Paul_Wood_Band__formerly_The_Bridgeburners-Don_t_Call_Me.mp3.wav	blues
/data0/juliano/homburg/blues/The_Paul_Wood_Band__formerly_The_Bridgeburners-Good_Day_4_Bad_Whiskey.mp3.wav	blues
/data0/juliano/homburg/blues/The_Pull-I_ve_Been_Searchin_.mp3.wav	blues
/data0/juliano/homburg/blues/The_Red_Rogers_Band-Cloudy_Day_Blues.mp3.wav	blues
/data0/juliano/homburg/blues/The_Rocket_Band-February_Rain.mp3.wav	blues
/data0/juliano/homburg/blues/The_Summertimeblues_Band-Honey_Bee.mp3.wav	blues
/data0/juliano/homburg/blues/The_Summertimeblues_Band-Sleepin__With_the_Blues.mp3.wav	blues
/data0/juliano/homburg/blues/The_Turnarounds-Heaven_Forgot_Us.mp3.wav	blues
/data0/juliano/homburg/blues/The_Turnarounds-I_Only_Want_To_Be_With_You.mp3.wav	blues
/data0/juliano/homburg/blues/The_Turnarounds-Jaded.mp3.wav	blues
/data0/juliano/homburg/blues/The_Turnarounds-Lights_Down_Low.mp3.wav	blues
/data0/juliano/homburg/blues/The_Turnarounds-Same_Mistake.mp3.wav	blues
/data0/juliano/homburg/blues/The_Turnarounds-Waiting_On_You.mp3.wav	blues
/data0/juliano/homburg/blues/The__Dare_Ya_Blues_Band-Home_to_New_Orleans.mp3.wav	blues
/data0/juliano/homburg/blues/The__Dare_Ya_Blues_Band-Me___I_Can_Toos.mp3.wav	blues
/data0/juliano/homburg/blues/The__Dare_Ya_Blues_Band-Think_I_know.mp3.wav	blues
/data0/juliano/homburg/blues/The__Dare_Ya_Blues_Band-Waisted_on_Club_Soda.mp3.wav	blues
/data0/juliano/homburg/blues/The__Dare_Ya_Blues_Band-wish_you_were_here.mp3.wav	blues
/data0/juliano/homburg/blues/Thirsty_Blues_Band-Aw_Yeah.mp3.wav	blues
/data0/juliano/homburg/blues/Toby_Ray_Lees_and_Outta_The_Blue-The_Face_Of_An_Angel.mp3.wav	blues
/data0/juliano/homburg/blues/Tom_Townsley_and_the_Backsliders-Casino_Katy.mp3.wav	blues
/data0/juliano/homburg/blues/Uschi_Wiese_and_Paul_Lawall_duo-Blues_for_Stevie.mp3.wav	blues
/data0/juliano/homburg/blues/Wallin_s_Blues-Away_From_Home.mp3.wav	blues
/data0/juliano/homburg/blues/West_of_Arizona-Smoke_Follows_Beauty.mp3.wav	blues
/data0/juliano/homburg/blues/Zach_Myers_Band-8_27_90.mp3.wav	blues
/data0/juliano/homburg/blues/barry_harvey-__ORIGINAL__BLACK___BLUE__MASTERPIECE_.mp3.wav	blues
/data0/juliano/homburg/blues/terrywall_thewallbangers-Sleepwalking.mp3.wav	blues
/data0/juliano/homburg/blues/the_River_Rats-Somethings_Never_Change.mp3.wav	blues
/data0/juliano/homburg/electronic/22-Lonely.mp3.wav	electronic
/data0/juliano/homburg/electronic/3pm-Supermodel_Fanatic.mp3.wav	electronic
/data0/juliano/homburg/electronic/Alms_For_Shanti-Everlife___remixed.mp3.wav	electronic
/data0/juliano/homburg/electronic/Angstfed-Action.mp3.wav	electronic
/data0/juliano/homburg/electronic/Angstfed-Killa.mp3.wav	electronic
/data0/juliano/homburg/electronic/Angstfed-Widowed.mp3.wav	electronic
/data0/juliano/homburg/electronic/Appogee-I_m_Yours.mp3.wav	electronic
/data0/juliano/homburg/electronic/Asy9-My_Salout.mp3.wav	electronic
/data0/juliano/homburg/electronic/Behavior-Anywhere_But_Here.mp3.wav	electronic
/data0/juliano/homburg/electronic/Bleep-I_m_Fine.mp3.wav	electronic
/data0/juliano/homburg/electronic/Bleep-Looster.mp3.wav	electronic
/data0/juliano/homburg/electronic/Bleep-Wovel.mp3.wav	electronic
/data0/juliano/homburg/electronic/Burgerproduction-Lost_Cowboy.mp3.wav	electronic
/data0/juliano/homburg/electronic/Byrock-The_Bell.mp3.wav	electronic
/data0/juliano/homburg/electronic/CAMusic-Deserted_Town.mp3.wav	electronic
/data0/juliano/homburg/electronic/COSM-Divinity.mp3.wav	electronic
/data0/juliano/homburg/electronic/Cargo_cult-Mirrored_Image.mp3.wav	electronic
/data0/juliano/homburg/electronic/Cargo_cult-Sol_naciente.mp3.wav	electronic
/data0/juliano/homburg/electronic/Crumbly-Catharsis_Overload.mp3.wav	electronic
/data0/juliano/homburg/electronic/Crumbly-Slak.mp3.wav	electronic
/data0/juliano/homburg/electronic/DEFRAG-OVER_AND_OUT_AND_UNDER.mp3.wav	electronic
/data0/juliano/homburg/electronic/Dangerous_Beauty-Wish.mp3.wav	electronic
/data0/juliano/homburg/electronic/Das_Mobius-Ligeia.mp3.wav	electronic
/data0/juliano/homburg/electronic/Diemembrence-AbolishThyHeavens.mp3.wav	electronic
/data0/juliano/homburg/electronic/Dracanyotlez-I_Got_The_Balls.mp3.wav	electronic
/data0/juliano/homburg/electronic/ELEVENTH_HOUR_EXILE-TALISMAN.mp3.wav	electronic
/data0/juliano/homburg/electronic/Earthphish-Soulcandy.mp3.wav	electronic
/data0/juliano/homburg/electronic/Effective_Now-Complete.mp3.wav	electronic
/data0/juliano/homburg/electronic/Egon_Strangler-The_Rubber_Jerusalem_Experiment.mp3.wav	electronic
/data0/juliano/homburg/electronic/Form_Alkaline-Rail_mix.mp3.wav	electronic
/data0/juliano/homburg/electronic/Gamsters-Back_From_Jazz.mp3.wav	electronic
/data0/juliano/homburg/electronic/Gea_Pea-Sea_Pea.mp3.wav	electronic
/data0/juliano/homburg/electronic/Groove_Maneuver-Ethereal.mp3.wav	electronic
/data0/juliano/homburg/electronic/HALFTONE_HIGHS-Help_Me.mp3.wav	electronic
/data0/juliano/homburg/electronic/Him___The_Drinks-The_Most_Beautiful_ATM_In_The_Western_Antilles.mp3.wav	electronic
/data0/juliano/homburg/electronic/HisHeavyHeart-Weightless.mp3.wav	electronic
/data0/juliano/homburg/electronic/House_of_Pancakes-Trials_and_Tribulations_of_a_Working_Class_Stiff.mp3.wav	electronic
/data0/juliano/homburg/electronic/Instinct_s_Bitch-reign.mp3.wav	electronic
/data0/juliano/homburg/electronic/John_Paul_Sharp-Fishing_For_Compliments.mp3.wav	electronic
/data0/juliano/homburg/electronic/Juerg_Jost-SM2.mp3.wav	electronic
/data0/juliano/homburg/electronic/K_K__ELECTRONICS-WATCH_EMILY_PLAY__TO_SYD_.mp3.wav	electronic
/data0/juliano/homburg/electronic/Kaje-Nothing_s_Changing_feat__Valntine.mp3.wav	electronic
/data0/juliano/homburg/electronic/Komputadora-The_Phenomenon.mp3.wav	electronic
/data0/juliano/homburg/electronic/Loons_in_the_Monastery-IRT__6_Downtown__3AM.mp3.wav	electronic
/data0/juliano/homburg/electronic/Lucight-Moving_at_the_speed_of_sound.mp3.wav	electronic
/data0/juliano/homburg/electronic/Lucy_in_the_Sky-The_impossible_planet.mp3.wav	electronic
/data0/juliano/homburg/electronic/Marius_Mellebye-freedom_of_man.mp3.wav	electronic
/data0/juliano/homburg/electronic/Matt_Taylor_Steel_Razor-The_Quest.mp3.wav	electronic
/data0/juliano/homburg/electronic/Matthew_McCullough-Hmm.mp3.wav	electronic
/data0/juliano/homburg/electronic/Matthew_McCullough-Signals.mp3.wav	electronic
/data0/juliano/homburg/electronic/Meidell_Music_Production-Expose.mp3.wav	electronic
/data0/juliano/homburg/electronic/Migg-Slow_Motion.mp3.wav	electronic
/data0/juliano/homburg/electronic/Mimizan-Release.mp3.wav	electronic
/data0/juliano/homburg/electronic/Misnomer-Start_the_Machine_Up.mp3.wav	electronic
/data0/juliano/homburg/electronic/Misnomer-What_You_Become.mp3.wav	electronic
/data0/juliano/homburg/electronic/Miss_Volatile-Morph.mp3.wav	electronic
/data0/juliano/homburg/electronic/NEXUS7-SUMMON.mp3.wav	electronic
/data0/juliano/homburg/electronic/Progenitor__Justin_Hess_-Leave_That_Beach.mp3.wav	electronic
/data0/juliano/homburg/electronic/RECEPTORS-disconnected.mp3.wav	electronic
/data0/juliano/homburg/electronic/RealSmash-Behind_the_Gate.mp3.wav	electronic
/data0/juliano/homburg/electronic/Ruined_Hours-Sometimes___.mp3.wav	electronic
/data0/juliano/homburg/electronic/SCURGE-POPTRONICA.mp3.wav	electronic
/data0/juliano/homburg/electronic/SPR-Asthmatique.mp3.wav	electronic
/data0/juliano/homburg/electronic/Seluah-Bled.mp3.wav	electronic
/data0/juliano/homburg/electronic/Sonic_Boutique-Opium_Din.mp3.wav	electronic
/data0/juliano/homburg/electronic/Stuart_Elliott-Solitude.mp3.wav	electronic
/data0/juliano/homburg/electronic/Sunburn-Dysfunction.mp3.wav	electronic
/data0/juliano/homburg/electronic/Symbiosis-Exetrist__Rapture_Mix_.mp3.wav	electronic
/data0/juliano/homburg/electronic/Symbiosis-Poema.mp3.wav	electronic
/data0/juliano/homburg/electronic/Synthetic_Movements-Speaking_In_Electronic_Tongues.mp3.wav	electronic
/data0/juliano/homburg/electronic/The_Cheaters_Club-anthony.mp3.wav	electronic
/data0/juliano/homburg/electronic/The_Cheaters_Club-clean_break.mp3.wav	electronic
/data0/juliano/homburg/electronic/The_Epitome_of_Sound-Deep_in_Thought.mp3.wav	electronic
/data0/juliano/homburg/electronic/The_Weather_Inside-24_7.mp3.wav	electronic
/data0/juliano/homburg/electronic/The_Weather_Inside-Streets_of_Jerusalem.mp3.wav	electronic
/data0/juliano/homburg/electronic/Thomas_Becker-Steps.mp3.wav	electronic
/data0/juliano/homburg/electronic/Timothy_Allan-Off_the_Mark.mp3.wav	electronic
/data0/juliano/homburg/electronic/ToR___garageband_com_toraudio-Fourty_Two.mp3.wav	electronic
/data0/juliano/homburg/electronic/Tone_Matrix-Silver.mp3.wav	electronic
/data0/juliano/homburg/electronic/Trudgernaut-The_Power_of_Pure.mp3.wav	electronic
/data0/juliano/homburg/electronic/Unorganized_Crime-Alessandra.mp3.wav	electronic
/data0/juliano/homburg/electronic/Van_der_Waal-Dark_Matters.mp3.wav	electronic
/data0/juliano/homburg/electronic/Van_der_Waal-Meeting_in_Secret.mp3.wav	electronic
/data0/juliano/homburg/electronic/Verbal_Kint-Seabreeze.mp3.wav	electronic
/data0/juliano/homburg/electronic/Verbal_Kint-The_Mexican.mp3.wav	electronic
/data0/juliano/homburg/electronic/Verbal_Kint-The_Temple_ft__Judie_Jay__Smooth_Trip_Mix_.mp3.wav	electronic
/data0/juliano/homburg/electronic/Versus_Us-All_Quiet___.mp3.wav	electronic
/data0/juliano/homburg/electronic/Voxinst-Motor.mp3.wav	electronic
/data0/juliano/homburg/electronic/Voxinst-Talk2Me.mp3.wav	electronic
/data0/juliano/homburg/electronic/Waldo-Midnight.mp3.wav	electronic
/data0/juliano/homburg/electronic/Zerobae-Tausende_Herden.mp3.wav	electronic
/data0/juliano/homburg/electronic/_States__f_The_Mind_-elephant.mp3.wav	electronic
/data0/juliano/homburg/electronic/__The_Membots__-How_Deep_Can_You_Dig_.mp3.wav	electronic
/data0/juliano/homburg/electronic/aKido-China_Babies.mp3.wav	electronic
/data0/juliano/homburg/electronic/aKido-Playtime.mp3.wav	electronic
/data0/juliano/homburg/electronic/amputatoe-frank__french_turtle_lover_salsa_party_remix_.mp3.wav	electronic
/data0/juliano/homburg/electronic/atonalis-thefirstindigothought.mp3.wav	electronic
/data0/juliano/homburg/electronic/bitterbeat-serpentineliar.mp3.wav	electronic
/data0/juliano/homburg/electronic/buz-erratik_dream__the_lukkiest_man_.mp3.wav	electronic
/data0/juliano/homburg/electronic/designerthumbs-Barbershop_Massacre.mp3.wav	electronic
/data0/juliano/homburg/electronic/doctor_echo-blue_sky.mp3.wav	electronic
/data0/juliano/homburg/electronic/girlfriendx-Verses.mp3.wav	electronic
/data0/juliano/homburg/electronic/hanover_physt-memory_serves.mp3.wav	electronic
/data0/juliano/homburg/electronic/hook-whats_inside_of_us.mp3.wav	electronic
/data0/juliano/homburg/electronic/messyman-OVERDOSE.mp3.wav	electronic
/data0/juliano/homburg/electronic/millionVALVE-Club_C.mp3.wav	electronic
/data0/juliano/homburg/electronic/mo__-Wicked_Street.mp3.wav	electronic
/data0/juliano/homburg/electronic/number231-Portals_of_Rhythm.mp3.wav	electronic
/data0/juliano/homburg/electronic/random_access_orkestra-Difference_Detector.mp3.wav	electronic
/data0/juliano/homburg/electronic/randomajestiq-sPIoverburn.mp3.wav	electronic
/data0/juliano/homburg/electronic/the_FLIR-Marea.mp3.wav	electronic
/data0/juliano/homburg/electronic/the_patty_hearst_project-no_ones_watching.mp3.wav	electronic
/data0/juliano/homburg/electronic/valderama-Money_Soldier.mp3.wav	electronic
/data0/juliano/homburg/folkcountry/3_Blind_Mice-Emily_Has_Compassion_Fatigue.mp3.wav	folkcountry
/data0/juliano/homburg/folkcountry/6_gun_5-Gone_Too_Far.mp3.wav	folkcountry
/data0/juliano/homburg/folkcountry/AFTER_ALL_THESE_YEARS-Marie.mp3.wav	folkcountry
/data0/juliano/homburg/folkcountry/Aaron_Cheney-If_He_Were_Alive_Today__He_d_Probably_Be_Dead_.mp3.wav	folkcountry
/data0/juliano/homburg/folkcountry/Aaron_Cheney-Intimate_Strangers.mp3.wav	folkcountry
/data0/juliano/homburg/folkcountry/Aaron_Wilkinson-Osho_mask.mp3.wav	folkcountry
/data0/juliano/homburg/folkcountry/Adam_Keith_Garner-Two_Reasons.mp3.wav	folkcountry
/data0/juliano/homburg/folkcountry/Alex_Chu-Refugee.mp3.wav	folkcountry
/data0/juliano/homburg/folkcountry/Alyson_Gilbert_and_Southbound-All_The_Man_I_Need.mp3.wav	folkcountry
/data0/juliano/homburg/folkcountry/American_Cosmos-Enough_s_Enough.mp3.wav	folkcountry
/data0/juliano/homburg/folkcountry/Andrew_Michael_Roussis-Who__.mp3.wav	folkcountry
/data0/juliano/homburg/folkcountry/Andy_Kropf_Band-Cold.mp3.wav	folkcountry
/data0/juliano/homburg/folkcountry/Andy_Kropf_Band-Ocean_Street.mp3.wav	folkcountry
/data0/juliano/homburg/folkcountry/Angie_Tucker-The_Healing_Pool.mp3.wav	folkcountry
/data0/juliano/homburg/folkcountry/Anjuli_Dawn-Under_the_Name.mp3.wav	folkcountry
/data0/juliano/homburg/folkcountry/Ann_Pence-Dog_s_Life.mp3.wav	folkcountry
/data0/juliano/homburg/folkcountry/Ann_Pence-Out_of_My_Mind.mp3.wav	folkcountry
/data0/juliano/homburg/folkcountry/Ann_Pence-Valentine_s_Day.mp3.wav	folkcountry
/data0/juliano/homburg/folkcountry/Anne_Heaton-Megan_and_Kevin.mp3.wav	folkcountry
/data0/juliano/homburg/folkcountry/Anytown-Feeling_Older.mp3.wav	folkcountry
/data0/juliano/homburg/folkcountry/ArtieDeanHarris-What_s_In_her_Genes.mp3.wav	folkcountry
/data0/juliano/homburg/folkcountry/Big_Blue_Hearts-Feel_So_Right.mp3.wav	folkcountry
/data0/juliano/homburg/folkcountry/Big_Blue_Hearts-Ordinary_People.mp3.wav	folkcountry
/data0/juliano/homburg/folkcountry/Big_Blue_Hearts-What_would_you_do_.mp3.wav	folkcountry
/data0/juliano/homburg/folkcountry/Billi_Patti-Send_Me_an_Angel.mp3.wav	folkcountry
/data0/juliano/homburg/folkcountry/Bird_and_Tines-Billy_Jones.mp3.wav	folkcountry
/data0/juliano/homburg/folkcountry/Bird_and_Tines-Don_t_You_Worry.mp3.wav	folkcountry
/data0/juliano/homburg/folkcountry/Bird_and_Tines-Girl_s_Night_Out.mp3.wav	folkcountry
/data0/juliano/homburg/folkcountry/Bird_and_Tines-Hello_America.mp3.wav	folkcountry
/data0/juliano/homburg/folkcountry/Bird_and_Tines-Honky_Tonks_In_Heaven.mp3.wav	folkcountry
/data0/juliano/homburg/folkcountry/Bird_and_Tines-Temporarily_Your_s.mp3.wav	folkcountry
/data0/juliano/homburg/folkcountry/Bird_and_Tines-That_s_The_Stuff.mp3.wav	folkcountry
/data0/juliano/homburg/folkcountry/Bobby_Brent-Dreamworld.mp3.wav	folkcountry
/data0/juliano/homburg/folkcountry/Bobby_Brent-With_All_My_Might.mp3.wav	folkcountry
/data0/juliano/homburg/folkcountry/Brookes_and_Hawley-Conga_Song.mp3.wav	folkcountry
/data0/juliano/homburg/folkcountry/Brother_Lowdown-Disappearing_World.mp3.wav	folkcountry
/data0/juliano/homburg/folkcountry/Bruce_David-Mississippi_Moon.mp3.wav	folkcountry
/data0/juliano/homburg/folkcountry/Cat_Caspar-Blue_Without_You.mp3.wav	folkcountry
/data0/juliano/homburg/folkcountry/Chelle_Murrey-Everyone_s_Got_Philosophy.mp3.wav	folkcountry
/data0/juliano/homburg/folkcountry/Chris_Crase_w_The_Rails-Factual_Fiction.mp3.wav	folkcountry
/data0/juliano/homburg/folkcountry/Christopher_Dale-At_Ease.mp3.wav	folkcountry
/data0/juliano/homburg/folkcountry/Christopher_Dallman-The_7th_of_September.mp3.wav	folkcountry
/data0/juliano/homburg/folkcountry/Christopher_Sauter-Something_About_You.mp3.wav	folkcountry
/data0/juliano/homburg/folkcountry/Colin_McConnell-Big_Sky.mp3.wav	folkcountry
/data0/juliano/homburg/folkcountry/Cowboy_Poets-Longneck_For_A_Short_Goodbye.mp3.wav	folkcountry
/data0/juliano/homburg/folkcountry/Cozmic_Donkey-Waltzing_Burro.mp3.wav	folkcountry
/data0/juliano/homburg/folkcountry/Creosote__AZ_-85.mp3.wav	folkcountry
/data0/juliano/homburg/folkcountry/DAVE_HARDIN-MEETIN_JESUS.mp3.wav	folkcountry
/data0/juliano/homburg/folkcountry/DAVE_HARDIN-The_Tree.mp3.wav	folkcountry
/data0/juliano/homburg/folkcountry/DOC_HOLIDAY_IT_ALL_COMES_BACK_TO_ME-What_Turns_You_On.mp3.wav	folkcountry
/data0/juliano/homburg/folkcountry/Dan_Crump_Band-London_s_Calling_Home.mp3.wav	folkcountry
/data0/juliano/homburg/folkcountry/David_Kendall-This_Time.mp3.wav	folkcountry
/data0/juliano/homburg/folkcountry/David_Plumb-Oo_La_La.mp3.wav	folkcountry
/data0/juliano/homburg/folkcountry/Davin_Wood-Left_Behind.mp3.wav	folkcountry
/data0/juliano/homburg/folkcountry/Day_One-Time__Acoustic_Live_.mp3.wav	folkcountry
/data0/juliano/homburg/folkcountry/DeWayne_Spaw-Strong.mp3.wav	folkcountry
/data0/juliano/homburg/folkcountry/Dennis_Gilman_Band-Sweet_Casandra.mp3.wav	folkcountry
/data0/juliano/homburg/folkcountry/Derek_James-Firefly.mp3.wav	folkcountry
/data0/juliano/homburg/folkcountry/Devon_Powell-With_You.mp3.wav	folkcountry
/data0/juliano/homburg/folkcountry/Dry_County-Alabama_Clay.mp3.wav	folkcountry
/data0/juliano/homburg/folkcountry/Dry_County-Lonelytown.mp3.wav	folkcountry
/data0/juliano/homburg/folkcountry/Dry_County-Money_To_Burn__Live_.mp3.wav	folkcountry
/data0/juliano/homburg/folkcountry/Dylan_Thomas_Vance-Mr_Franklin.mp3.wav	folkcountry
/data0/juliano/homburg/folkcountry/EXIT__from_Milwaukee__WI_-Dirt_Floor.mp3.wav	folkcountry
/data0/juliano/homburg/folkcountry/E_J__Wells-Rhyolite__Build_My_Gallows_High_.mp3.wav	folkcountry
/data0/juliano/homburg/folkcountry/Eclecticity_Music-Keep_On_Loving_Me.mp3.wav	folkcountry
/data0/juliano/homburg/folkcountry/Ellie-Lost.mp3.wav	folkcountry
/data0/juliano/homburg/folkcountry/Emory_Joseph-Daddy_John.mp3.wav	folkcountry
/data0/juliano/homburg/folkcountry/FOR_THE_CAUSE-Eden_June.mp3.wav	folkcountry
/data0/juliano/homburg/folkcountry/FOR_THE_CAUSE-This_is_what_love_looks_like.mp3.wav	folkcountry
/data0/juliano/homburg/folkcountry/FOR_THE_CAUSE-hanging_by_a_thread.mp3.wav	folkcountry
/data0/juliano/homburg/folkcountry/Fallen_Angels__Chicago_-Make_Me_A_Train.mp3.wav	folkcountry
/data0/juliano/homburg/folkcountry/Francisco_Lobato-Love_Of_My_Life.mp3.wav	folkcountry
/data0/juliano/homburg/folkcountry/Frank_Williamson-Ticket_To_Nashville.mp3.wav	folkcountry
/data0/juliano/homburg/folkcountry/Frozen_Feet-Mama.mp3.wav	folkcountry
/data0/juliano/homburg/folkcountry/Hattie-Come_Into_My_Room.mp3.wav	folkcountry
/data0/juliano/homburg/folkcountry/Hattie-Love_Chain.mp3.wav	folkcountry
/data0/juliano/homburg/folkcountry/Hattie-Winter_Blues.mp3.wav	folkcountry
/data0/juliano/homburg/folkcountry/Heather_Abrahams-Eternal_Fire.mp3.wav	folkcountry
/data0/juliano/homburg/folkcountry/Heather_Bodell-Forever_and_Always_Sample.mp3.wav	folkcountry
/data0/juliano/homburg/folkcountry/Hicks_In_Trucks-Rom_nce_TN.mp3.wav	folkcountry
/data0/juliano/homburg/folkcountry/Hillbilly_Winos-The_Grind.mp3.wav	folkcountry
/data0/juliano/homburg/folkcountry/Hillbillys_from_Space-Fortune_Cookies.mp3.wav	folkcountry
/data0/juliano/homburg/folkcountry/HogWhitman-Reds__Yellows__and_Rainbows.mp3.wav	folkcountry
/data0/juliano/homburg/folkcountry/Ian_McFeron_and_the_Band-Love_Me_Twice.mp3.wav	folkcountry
/data0/juliano/homburg/folkcountry/In_Blue_River-Japan.mp3.wav	folkcountry
/data0/juliano/homburg/folkcountry/In_Blue_River-The_Girl_in_the_Yellow_Dress.mp3.wav	folkcountry
/data0/juliano/homburg/folkcountry/JC_Smith-Dulcinea.mp3.wav	folkcountry
/data0/juliano/homburg/folkcountry/JD_Myers-If_Love_Was_Like_A_Train.mp3.wav	folkcountry
/data0/juliano/homburg/folkcountry/JEFF_WEST_AND_THE_JACKALS-NASHVILLE.mp3.wav	folkcountry
/data0/juliano/homburg/folkcountry/JNS-I_Know.mp3.wav	folkcountry
/data0/juliano/homburg/folkcountry/Jacques-That_Train_Song.mp3.wav	folkcountry
/data0/juliano/homburg/folkcountry/James_Theroux_Band-Hell_Bound_Train.mp3.wav	folkcountry
/data0/juliano/homburg/folkcountry/Jeff_Crandall-Rarebird.mp3.wav	folkcountry
/data0/juliano/homburg/folkcountry/Jennifer_Brantley-I_Need_A_Place.mp3.wav	folkcountry
/data0/juliano/homburg/folkcountry/Jenny_Lawrence-Ice.mp3.wav	folkcountry
/data0/juliano/homburg/folkcountry/Jessica_Eriksmoen-You_re_Gone.mp3.wav	folkcountry
/data0/juliano/homburg/folkcountry/Jim_Gilmour-Quarterline.mp3.wav	folkcountry
/data0/juliano/homburg/folkcountry/Jimi_Heath-A_Girl.mp3.wav	folkcountry
/data0/juliano/homburg/folkcountry/Jinder-Waiting_Line.mp3.wav	folkcountry
/data0/juliano/homburg/folkcountry/JoList-Nothing_Sweet.mp3.wav	folkcountry
/data0/juliano/homburg/folkcountry/Joe_Nobody-California.mp3.wav	folkcountry
/data0/juliano/homburg/folkcountry/Joseph_Hathaway-Why_Do_You_Keep_Trying_To_Break_My_Heart_In_Two.mp3.wav	folkcountry
/data0/juliano/homburg/folkcountry/JoshChristian-FOR_THE_LOVE_OF_MONEY.mp3.wav	folkcountry
/data0/juliano/homburg/folkcountry/JoshChristian-Welcome_Back.mp3.wav	folkcountry
/data0/juliano/homburg/folkcountry/Josh_Lederman_y_Los_Diablos-The_Northern_Wind.mp3.wav	folkcountry
/data0/juliano/homburg/folkcountry/Josh_Rubino-If_the_Sculpture_Could_Speak.mp3.wav	folkcountry
/data0/juliano/homburg/folkcountry/Josh_Rubino-Love_Will_Find_A_Way.mp3.wav	folkcountry
/data0/juliano/homburg/folkcountry/Jug_in_Hand-Brennon_on_the_Moor.mp3.wav	folkcountry
/data0/juliano/homburg/folkcountry/Jug_in_Hand-Nova_Scotia.mp3.wav	folkcountry
/data0/juliano/homburg/folkcountry/Justin_Sandercoe-Imperfect.mp3.wav	folkcountry
/data0/juliano/homburg/folkcountry/Kaytie_Austin-Boomerang.mp3.wav	folkcountry
/data0/juliano/homburg/folkcountry/Keith_Hinton-Prayer_for_Sara_Jane.mp3.wav	folkcountry
/data0/juliano/homburg/folkcountry/Keith_Thompson_and_the_Rye-Bayou_Lullaby.mp3.wav	folkcountry
/data0/juliano/homburg/folkcountry/Kevroy_Potter-When_I_Get_It_Right.mp3.wav	folkcountry
/data0/juliano/homburg/folkcountry/Leo_s_Leeway-Reckless_Tonight.mp3.wav	folkcountry
/data0/juliano/homburg/folkcountry/MILLENIUM_COWBOY-12_Step_Song.mp3.wav	folkcountry
/data0/juliano/homburg/folkcountry/MILLENIUM_COWBOY-ANTHEM_.mp3.wav	folkcountry
/data0/juliano/homburg/folkcountry/MILLENIUM_COWBOY-BUILD_A_BOAT_.mp3.wav	folkcountry
/data0/juliano/homburg/folkcountry/MILLENIUM_COWBOY-DOWN_THAT_ROAD___.mp3.wav	folkcountry
/data0/juliano/homburg/folkcountry/MILLENIUM_COWBOY-HARD_2_GET_A_WOMAN_OUT_OF_NEW_ORLEANS.mp3.wav	folkcountry
/data0/juliano/homburg/folkcountry/MILLENIUM_COWBOY-Sky_Today.mp3.wav	folkcountry
/data0/juliano/homburg/folkcountry/MOJO___Eugene__OR-Dreams.mp3.wav	folkcountry
/data0/juliano/homburg/folkcountry/Marc_Giannotti-worry_bout_that.mp3.wav	folkcountry
/data0/juliano/homburg/folkcountry/Maskil-Bighorn_Mountains.mp3.wav	folkcountry
/data0/juliano/homburg/folkcountry/Maskil-Silent_Warrior.mp3.wav	folkcountry
/data0/juliano/homburg/folkcountry/Mercer_Mayer-Master_of_the_Obvious.mp3.wav	folkcountry
/data0/juliano/homburg/folkcountry/Mike_Arechiga-American_Made.mp3.wav	folkcountry
/data0/juliano/homburg/folkcountry/Mike_Beck-The_Ghost_of_Mrs__Adler.mp3.wav	folkcountry
/data0/juliano/homburg/folkcountry/Nate_Pearce-Leavin__California.mp3.wav	folkcountry
/data0/juliano/homburg/folkcountry/Nathan_Davis-John_Coltrane.mp3.wav	folkcountry
/data0/juliano/homburg/folkcountry/Nathan_Sheppard-Carried_Away.mp3.wav	folkcountry
/data0/juliano/homburg/folkcountry/Nathan_Sheppard_2002-Carolina.mp3.wav	folkcountry
/data0/juliano/homburg/folkcountry/Nathan_Sheppard_2002-Dying_Day.mp3.wav	folkcountry
/data0/juliano/homburg/folkcountry/Nathan_Sheppard_Band-Traveling_On.mp3.wav	folkcountry
/data0/juliano/homburg/folkcountry/Nathan_Sheppard_II-Damn_Good_Dawg.mp3.wav	folkcountry
/data0/juliano/homburg/folkcountry/Noel_Shannon-Heading_South.mp3.wav	folkcountry
/data0/juliano/homburg/folkcountry/Noel_Shannon-How_far_can_you_fall.mp3.wav	folkcountry
/data0/juliano/homburg/folkcountry/Noel_Shannon-Long_Way_home.mp3.wav	folkcountry
/data0/juliano/homburg/folkcountry/Organ_Donors-Power_and_Glory.mp3.wav	folkcountry
/data0/juliano/homburg/folkcountry/Paper_Tiger-Life.mp3.wav	folkcountry
/data0/juliano/homburg/folkcountry/Pawnshop_Roses-Little_Star.mp3.wav	folkcountry
/data0/juliano/homburg/folkcountry/Pete__Berwick-Only_Bleeding.mp3.wav	folkcountry
/data0/juliano/homburg/folkcountry/Piedmont_Chris_Johnson-Tobacco___Tea.mp3.wav	folkcountry
/data0/juliano/homburg/folkcountry/Pondering_Judd-Caroline.mp3.wav	folkcountry
/data0/juliano/homburg/folkcountry/Pondering_Judd-Losing.mp3.wav	folkcountry
/data0/juliano/homburg/folkcountry/Pondering_Judd-Slim.mp3.wav	folkcountry
/data0/juliano/homburg/folkcountry/Porch_Daddies-Within_You.mp3.wav	folkcountry
/data0/juliano/homburg/folkcountry/Rebecca_Hall-Hard_Way_to_Learn.mp3.wav	folkcountry
/data0/juliano/homburg/folkcountry/Rebecca_Hall-Like_You_Do.mp3.wav	folkcountry
/data0/juliano/homburg/folkcountry/Rebecca_Hall-Not_the_Same.mp3.wav	folkcountry
/data0/juliano/homburg/folkcountry/Relative_Strangers-French_Girl.mp3.wav	folkcountry
/data0/juliano/homburg/folkcountry/Relative_Strangers-Salt_Lake_City.mp3.wav	folkcountry
/data0/juliano/homburg/folkcountry/Rob_Costlow___Solo_Piano-I_Do.mp3.wav	folkcountry
/data0/juliano/homburg/folkcountry/Rusty_Wilson-For_Sale_by_Owner.mp3.wav	folkcountry
/data0/juliano/homburg/folkcountry/Rusty_Wilson-I_m_to_Blame.mp3.wav	folkcountry
/data0/juliano/homburg/folkcountry/Ryan_Grove-The_Bright_Lights_of_Eleventh_Ave.mp3.wav	folkcountry
/data0/juliano/homburg/folkcountry/Scott_Cooper-The_Summer_Song.mp3.wav	folkcountry
/data0/juliano/homburg/folkcountry/Serena_Matthews-Here_in_the_Blue.mp3.wav	folkcountry
/data0/juliano/homburg/folkcountry/Seven_Harkey-Roadside_Dead.mp3.wav	folkcountry
/data0/juliano/homburg/folkcountry/Shannon_Campbell-Oblivion.mp3.wav	folkcountry
/data0/juliano/homburg/folkcountry/Sound_of_Gold-Here_comes_the_hurricane.mp3.wav	folkcountry
/data0/juliano/homburg/folkcountry/Sound_of_Gold-I_never_seen_her_since.mp3.wav	folkcountry
/data0/juliano/homburg/folkcountry/Sted_letter-Beauty_Love.mp3.wav	folkcountry
/data0/juliano/homburg/folkcountry/Steffan_May-Thanks_fer_wastin_me_yer_time.mp3.wav	folkcountry
/data0/juliano/homburg/folkcountry/Stephanie_Dosen-Sea_Mist_and_Mirrors.mp3.wav	folkcountry
/data0/juliano/homburg/folkcountry/Steve_Massey-Siskiyou_Reflections.mp3.wav	folkcountry
/data0/juliano/homburg/folkcountry/Steven_Francque-Brand_Of_Misery.mp3.wav	folkcountry
/data0/juliano/homburg/folkcountry/Syd-Back_Home.mp3.wav	folkcountry
/data0/juliano/homburg/folkcountry/TROLE-We_The_People.mp3.wav	folkcountry
/data0/juliano/homburg/folkcountry/Tari_Follett-No_Going_Back.mp3.wav	folkcountry
/data0/juliano/homburg/folkcountry/Telling_Stories-Undone.mp3.wav	folkcountry
/data0/juliano/homburg/folkcountry/Texas_Jack-Dear_You.mp3.wav	folkcountry
/data0/juliano/homburg/folkcountry/The_Black_Diamond_Band-Good_Morning_Highway.mp3.wav	folkcountry
/data0/juliano/homburg/folkcountry/The_Craig_Richards_Band-The_War_s_Never_Ending.mp3.wav	folkcountry
/data0/juliano/homburg/folkcountry/The_Flying_Garcias-Big_Texas_Sky.mp3.wav	folkcountry
/data0/juliano/homburg/folkcountry/The_Meadow_City_Band-Somewhere_East_of_Eden.mp3.wav	folkcountry
/data0/juliano/homburg/folkcountry/The_Mississippi_Kid-Mississippi_Kid.mp3.wav	folkcountry
/data0/juliano/homburg/folkcountry/The_Reunion-Day_Dreamin.mp3.wav	folkcountry
/data0/juliano/homburg/folkcountry/The_Shooting_Gallery-Harlan.mp3.wav	folkcountry
/data0/juliano/homburg/folkcountry/The_Spikedrivers-Ain_t_That_Bad.mp3.wav	folkcountry
/data0/juliano/homburg/folkcountry/The_Spikedrivers-Already.mp3.wav	folkcountry
/data0/juliano/homburg/folkcountry/The_Strangers-Memories_of_you.mp3.wav	folkcountry
/data0/juliano/homburg/folkcountry/The_Tom_Tighe_Band-It_s_High_Time.mp3.wav	folkcountry
/data0/juliano/homburg/folkcountry/The_White_Buffalo-The_Bar_and_the_Beer.mp3.wav	folkcountry
/data0/juliano/homburg/folkcountry/Tinsmith-Madam_I_m_A_Darlin_.mp3.wav	folkcountry
/data0/juliano/homburg/folkcountry/Tom_Cadaret-Gypsy_Night.mp3.wav	folkcountry
/data0/juliano/homburg/folkcountry/Tommy_Willis-I_Still_Wanna_Be_A_Cowboy.mp3.wav	folkcountry
/data0/juliano/homburg/folkcountry/Tony_Lechner-Ecstasy.mp3.wav	folkcountry
/data0/juliano/homburg/folkcountry/Tristan_Kromer-Rainmaker.mp3.wav	folkcountry
/data0/juliano/homburg/folkcountry/Tristan_Kromer-This_Day_Won_t_Last.mp3.wav	folkcountry
/data0/juliano/homburg/folkcountry/Trucker_Up-Red_Sovine.mp3.wav	folkcountry
/data0/juliano/homburg/folkcountry/Truckstop_Supermodel-Girlie_Store.mp3.wav	folkcountry
/data0/juliano/homburg/folkcountry/Twelfth_House-What_You_Don_t_Know.mp3.wav	folkcountry
/data0/juliano/homburg/folkcountry/Violethands-Mutawintji_Night.mp3.wav	folkcountry
/data0/juliano/homburg/folkcountry/Virginia-4_O_clock_In_The_Morning.mp3.wav	folkcountry
/data0/juliano/homburg/folkcountry/White_House_Intern-The_Man_of_My_Dreams.mp3.wav	folkcountry
/data0/juliano/homburg/folkcountry/anne_davis-no__i_m_not_going_anywhere.mp3.wav	folkcountry
/data0/juliano/homburg/folkcountry/anne_davis-temple_of_contradictions.mp3.wav	folkcountry
/data0/juliano/homburg/folkcountry/anne_davis-where_the_roads_cross.mp3.wav	folkcountry
/data0/juliano/homburg/folkcountry/brooksfoundjake-East.mp3.wav	folkcountry
/data0/juliano/homburg/folkcountry/caffeinedream-I_ll_Take_Austin.mp3.wav	folkcountry
/data0/juliano/homburg/folkcountry/christa_couture-i_will.mp3.wav	folkcountry
/data0/juliano/homburg/folkcountry/ethan_joy-deadbeat_town.mp3.wav	folkcountry
/data0/juliano/homburg/folkcountry/genuine_junk_band-In_Kentucky.mp3.wav	folkcountry
/data0/juliano/homburg/folkcountry/l_apparition-Black_Eyed_Baby.mp3.wav	folkcountry
/data0/juliano/homburg/folkcountry/manicdown-Pay_Attention.mp3.wav	folkcountry
/data0/juliano/homburg/folkcountry/matthew_smith-your_own_little_world.mp3.wav	folkcountry
/data0/juliano/homburg/folkcountry/matthews_granade-Opie_s_Blues.mp3.wav	folkcountry
/data0/juliano/homburg/folkcountry/melissa_warner_band-anything_but_brave.mp3.wav	folkcountry
/data0/juliano/homburg/folkcountry/melissa_warner_band-slim_chance.mp3.wav	folkcountry
/data0/juliano/homburg/folkcountry/no_soap_radio-What_You_re_Wearing.mp3.wav	folkcountry
/data0/juliano/homburg/folkcountry/noel_sullivan-Cowgirl_Cha_Cha.mp3.wav	folkcountry
/data0/juliano/homburg/folkcountry/one_lane_bridge-Get_Me_to_the_Rodeo.mp3.wav	folkcountry
/data0/juliano/homburg/folkcountry/ptM-Vacation_Getaway.mp3.wav	folkcountry
/data0/juliano/homburg/folkcountry/pubside_down-rockin__landlady.mp3.wav	folkcountry
/data0/juliano/homburg/folkcountry/roy_joseph-weathervane.mp3.wav	folkcountry
/data0/juliano/homburg/folkcountry/ryan_goins-Anchor.mp3.wav	folkcountry
/data0/juliano/homburg/folkcountry/samara_golabuk-In_These_Fresh_Hours.mp3.wav	folkcountry
/data0/juliano/homburg/folkcountry/strange_daisies-Pretty_Plastic_Flowers.mp3.wav	folkcountry
/data0/juliano/homburg/folkcountry/the_mojo_apostles-I_don_t_feel_like_drinking.mp3.wav	folkcountry
/data0/juliano/homburg/folkcountry/walkin_jesses-Queen_of_Clubs.mp3.wav	folkcountry
/data0/juliano/homburg/funksoulrnb/Afi-Same_Ole.mp3.wav	funksoulrnb
/data0/juliano/homburg/funksoulrnb/Barry_Aiken-Step_It_Up.mp3.wav	funksoulrnb
/data0/juliano/homburg/funksoulrnb/Chad_Trent-Common_Flaws.mp3.wav	funksoulrnb
/data0/juliano/homburg/funksoulrnb/Chad_Trent-Mr_Wonder.mp3.wav	funksoulrnb
/data0/juliano/homburg/funksoulrnb/Circus_Mind-Spy_Boy.mp3.wav	funksoulrnb
/data0/juliano/homburg/funksoulrnb/David_Boyles-Saturday.mp3.wav	funksoulrnb
/data0/juliano/homburg/funksoulrnb/Elio_Schiavo-The_Floyd_Patterson.mp3.wav	funksoulrnb
/data0/juliano/homburg/funksoulrnb/FUNKILINIUM-All_I_Ever_Wanted.mp3.wav	funksoulrnb
/data0/juliano/homburg/funksoulrnb/FUNKILINIUM-Fantasy_Girl.mp3.wav	funksoulrnb
/data0/juliano/homburg/funksoulrnb/Fungus_Amungus-slump.mp3.wav	funksoulrnb
/data0/juliano/homburg/funksoulrnb/Fuse___-After_All_I_Said.mp3.wav	funksoulrnb
/data0/juliano/homburg/funksoulrnb/Guytare-fugue__10.mp3.wav	funksoulrnb
/data0/juliano/homburg/funksoulrnb/Jaymz-She.mp3.wav	funksoulrnb
/data0/juliano/homburg/funksoulrnb/Jaymz-Thinkin__about_it.mp3.wav	funksoulrnb
/data0/juliano/homburg/funksoulrnb/Johnson-Perfect_Human_Specimen.mp3.wav	funksoulrnb
/data0/juliano/homburg/funksoulrnb/KongFuzi-Swamp_Gumbo.mp3.wav	funksoulrnb
/data0/juliano/homburg/funksoulrnb/Krystel-OK.mp3.wav	funksoulrnb
/data0/juliano/homburg/funksoulrnb/Mama_s_Gravy-Movin_Somebody.mp3.wav	funksoulrnb
/data0/juliano/homburg/funksoulrnb/Mojo_Mama-True_Colors.mp3.wav	funksoulrnb
/data0/juliano/homburg/funksoulrnb/Monia-Do_What_I_Gotta_Do.mp3.wav	funksoulrnb
/data0/juliano/homburg/funksoulrnb/Mother_Funk_Conspiracy-FUNKY_MCSUNKE.mp3.wav	funksoulrnb
/data0/juliano/homburg/funksoulrnb/Mothers_Favorite_Child-GENTLY___live.mp3.wav	funksoulrnb
/data0/juliano/homburg/funksoulrnb/Nina_Vidal-And_If_The_Rain.mp3.wav	funksoulrnb
/data0/juliano/homburg/funksoulrnb/Pennyshaker-Be_Blue.mp3.wav	funksoulrnb
/data0/juliano/homburg/funksoulrnb/Pennyshaker-Candy.mp3.wav	funksoulrnb
/data0/juliano/homburg/funksoulrnb/Phat_Phunktion-Always.mp3.wav	funksoulrnb
/data0/juliano/homburg/funksoulrnb/Seed_Is_____-Useless_Words.mp3.wav	funksoulrnb
/data0/juliano/homburg/funksoulrnb/Spooky_Jones-Get_Together.mp3.wav	funksoulrnb
/data0/juliano/homburg/funksoulrnb/StarBaby-Sunday_Night_Apology.mp3.wav	funksoulrnb
/data0/juliano/homburg/funksoulrnb/Taihisha___interCHEMISTRY-Fascination.mp3.wav	funksoulrnb
/data0/juliano/homburg/funksoulrnb/Telling_Stories-Pretty.mp3.wav	funksoulrnb
/data0/juliano/homburg/funksoulrnb/The_Blue_Method-All_In_Time.mp3.wav	funksoulrnb
/data0/juliano/homburg/funksoulrnb/The_Blue_Method-Don_t_They.mp3.wav	funksoulrnb
/data0/juliano/homburg/funksoulrnb/The_Blue_Method-Something_Devine.mp3.wav	funksoulrnb
/data0/juliano/homburg/funksoulrnb/The_Box-Pretty_Little_Birdyz.mp3.wav	funksoulrnb
/data0/juliano/homburg/funksoulrnb/Travis_Mandrell-Pick_Yourself_Up.mp3.wav	funksoulrnb
/data0/juliano/homburg/funksoulrnb/_REAL-Like_it_Like_You_Do_.mp3.wav	funksoulrnb
/data0/juliano/homburg/funksoulrnb/_REAL-Spread_A_Little_Love.mp3.wav	funksoulrnb
/data0/juliano/homburg/funksoulrnb/akay47-Money.mp3.wav	funksoulrnb
/data0/juliano/homburg/funksoulrnb/betty_in_black-Damn_I_m_Glad.mp3.wav	funksoulrnb
/data0/juliano/homburg/funksoulrnb/kanopus-HIGHER.mp3.wav	funksoulrnb
/data0/juliano/homburg/funksoulrnb/secondhand_jive-Birds__Dirt__and_Water.mp3.wav	funksoulrnb
/data0/juliano/homburg/funksoulrnb/secondhand_jive-San_Francisco.mp3.wav	funksoulrnb
/data0/juliano/homburg/funksoulrnb/teka__T_K__-I_Plan.mp3.wav	funksoulrnb
/data0/juliano/homburg/funksoulrnb/telos-Open_Your_Eyes.mp3.wav	funksoulrnb
/data0/juliano/homburg/funksoulrnb/the_rock_shop-dirty_mony.mp3.wav	funksoulrnb
/data0/juliano/homburg/funksoulrnb/thirst_-All_ways.mp3.wav	funksoulrnb
/data0/juliano/homburg/jazz/2ndnaycha-Zywickiii.mp3.wav	jazz
/data0/juliano/homburg/jazz/7_HILLS-Foster.mp3.wav	jazz
/data0/juliano/homburg/jazz/7_HILLS-The_Bellman.mp3.wav	jazz
/data0/juliano/homburg/jazz/ATMA-Big_Foot.mp3.wav	jazz
/data0/juliano/homburg/jazz/ATMA-Immanuel_s_Labor.mp3.wav	jazz
/data0/juliano/homburg/jazz/ATMA-Jack_s_Song.mp3.wav	jazz
/data0/juliano/homburg/jazz/AX_EUM-Me_Brudda.mp3.wav	jazz
/data0/juliano/homburg/jazz/Aberration_Quartet-Socially_Encumbrendt_Derelicts_Meet_The_Searing_En.mp3.wav	jazz
/data0/juliano/homburg/jazz/Acker_Bros-Dickey_Patrol.mp3.wav	jazz
/data0/juliano/homburg/jazz/Acker_Bros-Hoot_Owl_Waltz.mp3.wav	jazz
/data0/juliano/homburg/jazz/Adam_Smith-Conversations.mp3.wav	jazz
/data0/juliano/homburg/jazz/Akbar_Muhammad_Quartet-All_I_Want_is_Some_Damn_Respect.mp3.wav	jazz
/data0/juliano/homburg/jazz/Akbar_Muhammad_Quartet-Ebony_Beauty.mp3.wav	jazz
/data0/juliano/homburg/jazz/Akbar_Muhammad_Quartet-Song_for_My_Sister_Sandra.mp3.wav	jazz
/data0/juliano/homburg/jazz/Akbar_Muhammad_Quartet-The_Boss_Says___We_the_Best__.mp3.wav	jazz
/data0/juliano/homburg/jazz/Akbar_Muhammad_Quartet-The_Self_Expressive_Dance.mp3.wav	jazz
/data0/juliano/homburg/jazz/Andre_Donawa-A_Dolphin_s_Dream.mp3.wav	jazz
/data0/juliano/homburg/jazz/Andre_Donawa-Jamaican_Kung_Fu.mp3.wav	jazz
/data0/juliano/homburg/jazz/Astral_Wind-In_Expectation_Of_A_Miracle.mp3.wav	jazz
/data0/juliano/homburg/jazz/Azuris_Aurum-Soapjuice.mp3.wav	jazz
/data0/juliano/homburg/jazz/Azuris_Aurum-Terrene_Dream.mp3.wav	jazz
/data0/juliano/homburg/jazz/BankerDave-The_Mall.mp3.wav	jazz
/data0/juliano/homburg/jazz/BankerDave-White_Castle.mp3.wav	jazz
/data0/juliano/homburg/jazz/Barry_Aiken-Balboa_Park.mp3.wav	jazz
/data0/juliano/homburg/jazz/Bellsize-Golden_Center.mp3.wav	jazz
/data0/juliano/homburg/jazz/Berno_Sky-From_the_Dust.mp3.wav	jazz
/data0/juliano/homburg/jazz/Berno_Sky-Phusion.mp3.wav	jazz
/data0/juliano/homburg/jazz/Berno_Sky-Song_for_Sarah.mp3.wav	jazz
/data0/juliano/homburg/jazz/Big_Newton-Flyin_.mp3.wav	jazz
/data0/juliano/homburg/jazz/BlackBird-shadows_of_love.mp3.wav	jazz
/data0/juliano/homburg/jazz/Blip_Blop-Scrubby_Boppy.mp3.wav	jazz
/data0/juliano/homburg/jazz/Bloodwood-Cigarrette.mp3.wav	jazz
/data0/juliano/homburg/jazz/Bloodwood-Favela.mp3.wav	jazz
/data0/juliano/homburg/jazz/Bloodwood-Gutstrung.mp3.wav	jazz
/data0/juliano/homburg/jazz/Bloodwood-The_Summoning.mp3.wav	jazz
/data0/juliano/homburg/jazz/Burke_Ingraffia-Undercover.mp3.wav	jazz
/data0/juliano/homburg/jazz/Candali-One_Masquerade.mp3.wav	jazz
/data0/juliano/homburg/jazz/Chill_7-Red_s_Bed.mp3.wav	jazz
/data0/juliano/homburg/jazz/Chris_Bayne-Detour.mp3.wav	jazz
/data0/juliano/homburg/jazz/Chris_Bayne-Holiday.mp3.wav	jazz
/data0/juliano/homburg/jazz/Chris_Bayne-One_For_Joe.mp3.wav	jazz
/data0/juliano/homburg/jazz/Chris_Bayne-Smile.mp3.wav	jazz
/data0/juliano/homburg/jazz/Chris_Greene_and_New_Perspective-Adamantium__Redux_.mp3.wav	jazz
/data0/juliano/homburg/jazz/Chris_Greene_and_New_Perspective-Core_of_Vitality.mp3.wav	jazz
/data0/juliano/homburg/jazz/Chris_Greene_and_New_Perspective-Mr__Congeniality.mp3.wav	jazz
/data0/juliano/homburg/jazz/Christie_McCarthy-Nothing_Moves_Me.mp3.wav	jazz
/data0/juliano/homburg/jazz/Cold_Duck_Complex-91_Norch.mp3.wav	jazz
/data0/juliano/homburg/jazz/Coolface-Checkmate.mp3.wav	jazz
/data0/juliano/homburg/jazz/Coolface-Seven_Islands.mp3.wav	jazz
/data0/juliano/homburg/jazz/DLO_Da_LEMMINGS_OnSombol_-KLAW.mp3.wav	jazz
/data0/juliano/homburg/jazz/Dave_Ahl-untitled.mp3.wav	jazz
/data0/juliano/homburg/jazz/Dave_Manley_Band-Deep_Pm.mp3.wav	jazz
/data0/juliano/homburg/jazz/Dave_Manley_Band-Sing_Sing.mp3.wav	jazz
/data0/juliano/homburg/jazz/Dave_Olsen-Dark_Continent.mp3.wav	jazz
/data0/juliano/homburg/jazz/David_Cortopassi-No_One_Gets_Me_Up_Like_You_Do.mp3.wav	jazz
/data0/juliano/homburg/jazz/Delve-Cookies_in_the_Microwave.mp3.wav	jazz
/data0/juliano/homburg/jazz/Delve-Is_That_Right.mp3.wav	jazz
/data0/juliano/homburg/jazz/Demented_Head-Lost_Season.mp3.wav	jazz
/data0/juliano/homburg/jazz/Demented_Head-The_Unknown_Tale.mp3.wav	jazz
/data0/juliano/homburg/jazz/Demented_Head-Wings_on_a_Venture.mp3.wav	jazz
/data0/juliano/homburg/jazz/Dick_John-Rock_is_dead_.mp3.wav	jazz
/data0/juliano/homburg/jazz/Dictatertots-Midnight_Trip_To_Nowhere.mp3.wav	jazz
/data0/juliano/homburg/jazz/Diego_Jinkus___Electronic_Miel-FonkenProject.mp3.wav	jazz
/data0/juliano/homburg/jazz/Dirty_Funk__Post_No_Bills_-Canadian_Calypso.mp3.wav	jazz
/data0/juliano/homburg/jazz/DreamLin-Nostalji.mp3.wav	jazz
/data0/juliano/homburg/jazz/Drexel_Jazz_Fusion-Betting_on_the_Banana_Heat.mp3.wav	jazz
/data0/juliano/homburg/jazz/Drexel_Jazz_Fusion-Claudette.mp3.wav	jazz
/data0/juliano/homburg/jazz/Drexel_Jazz_Fusion-Neuman.mp3.wav	jazz
/data0/juliano/homburg/jazz/Drop_Trio-Melody_Melody.mp3.wav	jazz
/data0/juliano/homburg/jazz/ED_Englerth-2Q.mp3.wav	jazz
/data0/juliano/homburg/jazz/El_Circulo_de_Willis-La_Maleta.mp3.wav	jazz
/data0/juliano/homburg/jazz/Epsilons-Centrifugal_Bumblepuppy.mp3.wav	jazz
/data0/juliano/homburg/jazz/Evil_Jungle-See_Saw.mp3.wav	jazz
/data0/juliano/homburg/jazz/FStylee-Leipzig.mp3.wav	jazz
/data0/juliano/homburg/jazz/FStylee-REVOLVER.mp3.wav	jazz
/data0/juliano/homburg/jazz/Fast_Forward-Old_Age__my_ass_.mp3.wav	jazz
/data0/juliano/homburg/jazz/Fat_Time-Blues_for_Herman.mp3.wav	jazz
/data0/juliano/homburg/jazz/Fat_Time-Jean_Jacques_Octeau.mp3.wav	jazz
/data0/juliano/homburg/jazz/Fatih_Ozel-Rondo_Orient.mp3.wav	jazz
/data0/juliano/homburg/jazz/Faux_Pas__2_-la_faite_commme_ca.mp3.wav	jazz
/data0/juliano/homburg/jazz/Flim_Flam-Chitlins_con_Carne.mp3.wav	jazz
/data0/juliano/homburg/jazz/Force_Seven-Glass_Eye.mp3.wav	jazz
/data0/juliano/homburg/jazz/Force_Seven-Joel_s_Friends.mp3.wav	jazz
/data0/juliano/homburg/jazz/Forte_-Baby_Don_t.mp3.wav	jazz
/data0/juliano/homburg/jazz/Forte_-Cool_Sheets.mp3.wav	jazz
/data0/juliano/homburg/jazz/Forte_-Sweet_Juice.mp3.wav	jazz
/data0/juliano/homburg/jazz/Fr_d_ric_Van_Coppernolle-I_Feel_Good_Now.mp3.wav	jazz
/data0/juliano/homburg/jazz/Funksquad-Cat_Cranium.mp3.wav	jazz
/data0/juliano/homburg/jazz/Funksquad-The_Bishop.mp3.wav	jazz
/data0/juliano/homburg/jazz/GARY_DEAN_SMITH-COMING_TO_PIECES.mp3.wav	jazz
/data0/juliano/homburg/jazz/GARY_DEAN_SMITH-LENNY_S_LAMENT.mp3.wav	jazz
/data0/juliano/homburg/jazz/GATE_18-LANDLORD.mp3.wav	jazz
/data0/juliano/homburg/jazz/Gail_Dutchess-Oscillation.mp3.wav	jazz
/data0/juliano/homburg/jazz/Geoff_Duncan-Only_After_the_Sky.mp3.wav	jazz
/data0/juliano/homburg/jazz/Geoff_Mattoon-Beam_me_Up.mp3.wav	jazz
/data0/juliano/homburg/jazz/Geoff_Mattoon-I_I_S_G_D_I___Will_Lee_on_fretless_bass_.mp3.wav	jazz
/data0/juliano/homburg/jazz/Geoff_Mattoon-J_S__Bop_featuring_Will_Lee__Chuck_Loeb.mp3.wav	jazz
/data0/juliano/homburg/jazz/George_McRae-A_Little_Taste.mp3.wav	jazz
/data0/juliano/homburg/jazz/Groovatron-Hey.mp3.wav	jazz
/data0/juliano/homburg/jazz/Guytare-Cantons_de_l_Est.mp3.wav	jazz
/data0/juliano/homburg/jazz/Guytare-Melting_pot.mp3.wav	jazz
/data0/juliano/homburg/jazz/Gwen_Cardenas___Kin-Me_And_The_Moon.mp3.wav	jazz
/data0/juliano/homburg/jazz/Half_A_Wreck-Puerto_Rican_Popcorn.mp3.wav	jazz
/data0/juliano/homburg/jazz/Heather_Waters-March.mp3.wav	jazz
/data0/juliano/homburg/jazz/Heitor_Castro-Fogo_e_Agua.mp3.wav	jazz
/data0/juliano/homburg/jazz/Heitor_Castro-Prana.mp3.wav	jazz
/data0/juliano/homburg/jazz/Heitor_Castro-The_Opening_Window.mp3.wav	jazz
/data0/juliano/homburg/jazz/Impact_-The_Cruise.mp3.wav	jazz
/data0/juliano/homburg/jazz/JOHN_VALENTI-Rosario_s_Song.mp3.wav	jazz
/data0/juliano/homburg/jazz/JP_Pasquier-Characas.mp3.wav	jazz
/data0/juliano/homburg/jazz/JP_Pasquier-Whoops__.mp3.wav	jazz
/data0/juliano/homburg/jazz/James_Cherry-Bring_You_Down.mp3.wav	jazz
/data0/juliano/homburg/jazz/Jeff_Curry-Bean_Bag.mp3.wav	jazz
/data0/juliano/homburg/jazz/Jeff_Curry-Born_of_Fire.mp3.wav	jazz
/data0/juliano/homburg/jazz/Jeff_Oestreich-Cool_Shade.mp3.wav	jazz
/data0/juliano/homburg/jazz/Jim_Crew-Blue_Streak.mp3.wav	jazz
/data0/juliano/homburg/jazz/Jim_Crew-Neckbone.mp3.wav	jazz
/data0/juliano/homburg/jazz/Jim_Schweigert-Goodbye_Green_Eyes.mp3.wav	jazz
/data0/juliano/homburg/jazz/Jimi_Ruccolo_Band-Off_the_Leash.mp3.wav	jazz
/data0/juliano/homburg/jazz/Jimi_Ruccolo_Band-Pride_Before_the_Fall.mp3.wav	jazz
/data0/juliano/homburg/jazz/Joe_Anikewich-Simone.mp3.wav	jazz
/data0/juliano/homburg/jazz/Joe_Turley-35_Cents.mp3.wav	jazz
/data0/juliano/homburg/jazz/Joe_Turley-Like_I_Doo.mp3.wav	jazz
/data0/juliano/homburg/jazz/John_Kline-Livin__in_a_Fish_Bowl.mp3.wav	jazz
/data0/juliano/homburg/jazz/John_Kline-Meridians.mp3.wav	jazz
/data0/juliano/homburg/jazz/John_Temmerman_s_Jazz_Obsession_Quartet-Fundamental_Dreamer.mp3.wav	jazz
/data0/juliano/homburg/jazz/John_Temmerman_s_Jazz_Obsession_Quartet-The_Gadfly.mp3.wav	jazz
/data0/juliano/homburg/jazz/Jon_Raney_Trio-Before_I_Close_My_Eyes.mp3.wav	jazz
/data0/juliano/homburg/jazz/Jon_Raney_Trio-Dedicated_To_Bill.mp3.wav	jazz
/data0/juliano/homburg/jazz/Just_Think-Hourglass.mp3.wav	jazz
/data0/juliano/homburg/jazz/Justin_Hoy-City_Life.mp3.wav	jazz
/data0/juliano/homburg/jazz/K_Comp-Persona__Live_.mp3.wav	jazz
/data0/juliano/homburg/jazz/K_Comp-Scene_Of_The_Crime__Live_.mp3.wav	jazz
/data0/juliano/homburg/jazz/K_Comp-Touch_the_Earth__Live_.mp3.wav	jazz
/data0/juliano/homburg/jazz/Kaleidoscope_Eyes-Take_A_Chance_With_Me.mp3.wav	jazz
/data0/juliano/homburg/jazz/Katjar-Le_funambule.mp3.wav	jazz
/data0/juliano/homburg/jazz/Ken_Skinner_and_the_jazzmongers_-Maroon.mp3.wav	jazz
/data0/juliano/homburg/jazz/Ken_Skinner_and_the_jazzmongers_-Tell_Me_Lies.mp3.wav	jazz
/data0/juliano/homburg/jazz/Kick_the_Cat-Blow_Me.mp3.wav	jazz
/data0/juliano/homburg/jazz/Kick_the_Cat-Era__The_Common_Man.mp3.wav	jazz
/data0/juliano/homburg/jazz/Kick_the_Cat-Porno_Jazz.mp3.wav	jazz
/data0/juliano/homburg/jazz/King_Teddy-Anybody_But_You.mp3.wav	jazz
/data0/juliano/homburg/jazz/King_Teddy-Phantom_Of_Main_and_Ordinary_Street.mp3.wav	jazz
/data0/juliano/homburg/jazz/Kjetil_Raustol-Blue_Falls.mp3.wav	jazz
/data0/juliano/homburg/jazz/Kung_Fuzion-Songo_da_Flauta.mp3.wav	jazz
/data0/juliano/homburg/jazz/La_Tribu-Ataca.mp3.wav	jazz
/data0/juliano/homburg/jazz/La_Tribu-Sylvia.mp3.wav	jazz
/data0/juliano/homburg/jazz/Larry_Janacek-Desert_Dreams.mp3.wav	jazz
/data0/juliano/homburg/jazz/LavaTrax-She_s_A_Good_One.mp3.wav	jazz
/data0/juliano/homburg/jazz/League_of_Mercy-Love_Song.mp3.wav	jazz
/data0/juliano/homburg/jazz/Lindsay_Wynn-November_Moon.mp3.wav	jazz
/data0/juliano/homburg/jazz/Lindsay_Wynn-The_Art_of_Making_Love.mp3.wav	jazz
/data0/juliano/homburg/jazz/Little_Blue_Crunchy_Things-Direction.mp3.wav	jazz
/data0/juliano/homburg/jazz/Lounge_Puppy-This_is_Acid_Jazz_.mp3.wav	jazz
/data0/juliano/homburg/jazz/Machine_Love-Midnight_World.mp3.wav	jazz
/data0/juliano/homburg/jazz/Marc_Trachtenberg-Listen_to_Love.mp3.wav	jazz
/data0/juliano/homburg/jazz/Mento_Buru-Skabolero.mp3.wav	jazz
/data0/juliano/homburg/jazz/Michael_J_Thomas-Yo__Mr__Saxman.mp3.wav	jazz
/data0/juliano/homburg/jazz/Mike_Hay-No_Speed_Limits.mp3.wav	jazz
/data0/juliano/homburg/jazz/Mister_Marek-Ann.mp3.wav	jazz
/data0/juliano/homburg/jazz/Mister_Marek-Flowing_Spring.mp3.wav	jazz
/data0/juliano/homburg/jazz/Mister_Marek-Mellow_Breeze.mp3.wav	jazz
/data0/juliano/homburg/jazz/Mister_Marek-On_Top_Of_The_Mountain.mp3.wav	jazz
/data0/juliano/homburg/jazz/Monika_Herzig-Blues_for_a_Rainy_Day.mp3.wav	jazz
/data0/juliano/homburg/jazz/Monika_Herzig-Evening_Mood.mp3.wav	jazz
/data0/juliano/homburg/jazz/Monika_Herzig-One_for_the_Box.mp3.wav	jazz
/data0/juliano/homburg/jazz/Mood_Indigo-Samba_Kabassa_Quartet_Version.mp3.wav	jazz
/data0/juliano/homburg/jazz/Mood_Indigo-Step_Up_Seymour.mp3.wav	jazz
/data0/juliano/homburg/jazz/Mood_Indigo-Tibb_s_Samba.mp3.wav	jazz
/data0/juliano/homburg/jazz/Mother_Funk_Conspiracy-HAMBONE_steaksauce.mp3.wav	jazz
/data0/juliano/homburg/jazz/Non_Sens-The_waiting.mp3.wav	jazz
/data0/juliano/homburg/jazz/Nosmo_King-Affirmation.mp3.wav	jazz
/data0/juliano/homburg/jazz/Nova_Paradiso-Kuno_Tzajalia.mp3.wav	jazz
/data0/juliano/homburg/jazz/ONOFFON-Weekend_In_Montreal__Remix_.mp3.wav	jazz
/data0/juliano/homburg/jazz/Orquesta_Ranura-Song_for_the_Founders.mp3.wav	jazz
/data0/juliano/homburg/jazz/PC_BIG_DADDY_G-More_Coolness.mp3.wav	jazz
/data0/juliano/homburg/jazz/PETE_CARR-ZETA_RETICULI.mp3.wav	jazz
/data0/juliano/homburg/jazz/Paul_Fisher_and_the_Mulligan_Kings-Paul_s_52nd_st__Theme.mp3.wav	jazz
/data0/juliano/homburg/jazz/Peak_Velocity_s_Rhythm_Review-Home_Cookin_.mp3.wav	jazz
/data0/juliano/homburg/jazz/Peak_Velocity_s_Rhythm_Review-song_3.mp3.wav	jazz
/data0/juliano/homburg/jazz/Penny_Watson-Everyday.mp3.wav	jazz
/data0/juliano/homburg/jazz/Pete_Ubriaco-Never_Trust_A_Pink_House.mp3.wav	jazz
/data0/juliano/homburg/jazz/Pete_Ubriaco-San_Pedro_Hum.mp3.wav	jazz
/data0/juliano/homburg/jazz/Pete_Watson-Summertime.mp3.wav	jazz
/data0/juliano/homburg/jazz/Possible_Bad_News-Bed_Spring.mp3.wav	jazz
/data0/juliano/homburg/jazz/Possible_Bad_News-Rooster_Funk.mp3.wav	jazz
/data0/juliano/homburg/jazz/Quadrophonic-Jigsaw.mp3.wav	jazz
/data0/juliano/homburg/jazz/ROMBAL-Venus_effect.mp3.wav	jazz
/data0/juliano/homburg/jazz/RPMoore-Toltec.mp3.wav	jazz
/data0/juliano/homburg/jazz/Randal_Pflum-Peace_Beyond_Understanding.mp3.wav	jazz
/data0/juliano/homburg/jazz/Rare_Blend-Cool_Days_Hot_Nights.mp3.wav	jazz
/data0/juliano/homburg/jazz/Rare_Medium-Keep_It_Up.mp3.wav	jazz
/data0/juliano/homburg/jazz/Rich_Hansen-Four_On_The_Floor.mp3.wav	jazz
/data0/juliano/homburg/jazz/Rick_Cucuzza-The_Gift.mp3.wav	jazz
/data0/juliano/homburg/jazz/Rick_Isbell-Out_of_the_Blue.mp3.wav	jazz
/data0/juliano/homburg/jazz/Rik_Barba-Irma.mp3.wav	jazz
/data0/juliano/homburg/jazz/Rob_Walker-Fresh_Start.mp3.wav	jazz
/data0/juliano/homburg/jazz/Rob_Walker-Pickin_On_Stix.mp3.wav	jazz
/data0/juliano/homburg/jazz/Robin_Dean-Breastamanipples.mp3.wav	jazz
/data0/juliano/homburg/jazz/Robin_Hackett-Sayin__Goodbye.mp3.wav	jazz
/data0/juliano/homburg/jazz/Rude_On_The_Rhine-Bumble_It_All.mp3.wav	jazz
/data0/juliano/homburg/jazz/Rude_On_The_Rhine-Erp_Swings_His_Hammer.mp3.wav	jazz
/data0/juliano/homburg/jazz/Rude_On_The_Rhine-Funsion.mp3.wav	jazz
/data0/juliano/homburg/jazz/Russ_Bryant_Group-A_Cool_Day.mp3.wav	jazz
/data0/juliano/homburg/jazz/Russ_Bryant_Group-Atlanta_Traffic.mp3.wav	jazz
/data0/juliano/homburg/jazz/Russ_Bryant_Group-Falling_Time.mp3.wav	jazz
/data0/juliano/homburg/jazz/Russ_Bryant_Group-Never_Assume.mp3.wav	jazz
/data0/juliano/homburg/jazz/SAE-Ashbury.mp3.wav	jazz
/data0/juliano/homburg/jazz/SCHFViLKUS-Pleather.mp3.wav	jazz
/data0/juliano/homburg/jazz/SLQ-Blues_For_Joey.mp3.wav	jazz
/data0/juliano/homburg/jazz/Sarah_Gabriel-Moonlight.mp3.wav	jazz
/data0/juliano/homburg/jazz/Saukville_Bass_Trio-The_Bassics.mp3.wav	jazz
/data0/juliano/homburg/jazz/Scott_Pazera-Pigeon_Toed.mp3.wav	jazz
/data0/juliano/homburg/jazz/Scott_Pazera_Trio-42.mp3.wav	jazz
/data0/juliano/homburg/jazz/Scott_Pazera_Trio-Seven_Eleven.mp3.wav	jazz
/data0/juliano/homburg/jazz/Scott_Pazera_Trio-Sugarsnap.mp3.wav	jazz
/data0/juliano/homburg/jazz/Secret_Admirers-A_Certain_Mood.mp3.wav	jazz
/data0/juliano/homburg/jazz/Secret_Admirers-Meeting_of_the_Minds.mp3.wav	jazz
/data0/juliano/homburg/jazz/Semino_5-Semino5.mp3.wav	jazz
/data0/juliano/homburg/jazz/Shape_of_Shade-Fabric_Anvil.mp3.wav	jazz
/data0/juliano/homburg/jazz/Shatterproof_Glass-Pick_It_Up_Dig_It.mp3.wav	jazz
/data0/juliano/homburg/jazz/Silliputti-Miles__Live_Church_Mix_.mp3.wav	jazz
/data0/juliano/homburg/jazz/Silliputti-Moon_Walk.mp3.wav	jazz
/data0/juliano/homburg/jazz/Soda_Popinski-Any_Ideas.mp3.wav	jazz
/data0/juliano/homburg/jazz/Solla_Sollew-Blues_a_la_Cado.mp3.wav	jazz
/data0/juliano/homburg/jazz/Solsticequinox-Moondance.mp3.wav	jazz
/data0/juliano/homburg/jazz/Solsticequinox-intergalactic_freeway_shuttle_bus.mp3.wav	jazz
/data0/juliano/homburg/jazz/Soul_Rebels-I_m_Worse.mp3.wav	jazz
/data0/juliano/homburg/jazz/Speed_Limit_35_-ReKrupaRation.mp3.wav	jazz
/data0/juliano/homburg/jazz/Spirit_Zone-Spirit_De_Amor.mp3.wav	jazz
/data0/juliano/homburg/jazz/Stefan_Olofsson-Snow_Fever.mp3.wav	jazz
/data0/juliano/homburg/jazz/Stefan_Olofsson-Strait_From_The_Jacket.mp3.wav	jazz
/data0/juliano/homburg/jazz/Stop_Irrational_Logic-Jennifers_Flower.mp3.wav	jazz
/data0/juliano/homburg/jazz/Stop_Irrational_Logic-THE_SPACE_TRANCE.mp3.wav	jazz
/data0/juliano/homburg/jazz/Sunshine-Someone_who_belongs_to_me.mp3.wav	jazz
/data0/juliano/homburg/jazz/SwingSet_Quintet-The_Chuckler.mp3.wav	jazz
/data0/juliano/homburg/jazz/Tamara_Wellons-Spring_Giddiness.mp3.wav	jazz
/data0/juliano/homburg/jazz/Test_Type_Trio-New_Glitch.mp3.wav	jazz
/data0/juliano/homburg/jazz/That_Much-saphiro_dedal.mp3.wav	jazz
/data0/juliano/homburg/jazz/The_2_plus_1_Trio-Main_Street.mp3.wav	jazz
/data0/juliano/homburg/jazz/The_2_plus_1_Trio-Unmentionable.mp3.wav	jazz
/data0/juliano/homburg/jazz/The_Alan_Hayes_Project-Evening_Sunrise.mp3.wav	jazz
/data0/juliano/homburg/jazz/The_Auburn_Knights_Orchestra-Fly_Me_to_the_Moon.mp3.wav	jazz
/data0/juliano/homburg/jazz/The_Auburn_Knights_Orchestra-St__Thomas.mp3.wav	jazz
/data0/juliano/homburg/jazz/The_BLADE_CO_-The_Journey_.mp3.wav	jazz
/data0/juliano/homburg/jazz/The_Billy_Laffoday_Band-Dance_With_the_Lady.mp3.wav	jazz
/data0/juliano/homburg/jazz/The_Bonuts-Lady_on_a_Spiral_Staircase.mp3.wav	jazz
/data0/juliano/homburg/jazz/The_Bonuts-Life_With_Irene.mp3.wav	jazz
/data0/juliano/homburg/jazz/The_Bonuts-Monkman.mp3.wav	jazz
/data0/juliano/homburg/jazz/The_Coldest_Drink_in_Town-Sneaky_Man.mp3.wav	jazz
/data0/juliano/homburg/jazz/The_Combustion_Collective-Crime_of_Onan.mp3.wav	jazz
/data0/juliano/homburg/jazz/The_Combustion_Collective-Hank_s_Luck_Runs_Out.mp3.wav	jazz
/data0/juliano/homburg/jazz/The_Combustion_Collective-I_Like_To_Scream.mp3.wav	jazz
/data0/juliano/homburg/jazz/The_DW_Project-Itch_and_Scratch.mp3.wav	jazz
/data0/juliano/homburg/jazz/The_DW_Project-Prayer.mp3.wav	jazz
/data0/juliano/homburg/jazz/The_Funk_Heights_Affair-Matters_of_the_Heart.mp3.wav	jazz
/data0/juliano/homburg/jazz/The_Funk_Heights_Affair-Woodpecker_s_Reprise.mp3.wav	jazz
/data0/juliano/homburg/jazz/The_Industrial_Jazz_Group-Plus_or_Minus_Eleven.mp3.wav	jazz
/data0/juliano/homburg/jazz/The_Jeremy_Cubert_Project-Happy_The_Fan.mp3.wav	jazz
/data0/juliano/homburg/jazz/The_Larry_Steen_World_Jazz_Ensemble-Break_The_Ice.mp3.wav	jazz
/data0/juliano/homburg/jazz/The_Larry_Steen_World_Jazz_Ensemble-Dervishland.mp3.wav	jazz
/data0/juliano/homburg/jazz/The_Larry_Steen_World_Jazz_Ensemble-Drum__N_Barong.mp3.wav	jazz
/data0/juliano/homburg/jazz/The_Larry_Steen_World_Jazz_Ensemble-Matu__reclass_.mp3.wav	jazz
/data0/juliano/homburg/jazz/The_Larry_Steen_World_Jazz_Ensemble-Seven_Come_Five.mp3.wav	jazz
/data0/juliano/homburg/jazz/The_Larry_Steen_World_Jazz_Ensemble-Whelan_s_Jig.mp3.wav	jazz
/data0/juliano/homburg/jazz/The_Likes_Of_Me-See_Minor.mp3.wav	jazz
/data0/juliano/homburg/jazz/The_Meadow_City_Band-Autumn_Walk.mp3.wav	jazz
/data0/juliano/homburg/jazz/The_Mike_Arnold_Jazz_Company-Seven.mp3.wav	jazz
/data0/juliano/homburg/jazz/The_Old_Dogs_at_Play-Snatch_Crackers.mp3.wav	jazz
/data0/juliano/homburg/jazz/The_Reunion-12_Days.mp3.wav	jazz
/data0/juliano/homburg/jazz/The_Reunion-Leaving.mp3.wav	jazz
/data0/juliano/homburg/jazz/The_Reunion-Woman_of_the_Sea.mp3.wav	jazz
/data0/juliano/homburg/jazz/The_Slicked_Up_9_s-A_Wee_Bit_Gloomy.mp3.wav	jazz
/data0/juliano/homburg/jazz/The_Slicked_Up_9_s-Big_Bess.mp3.wav	jazz
/data0/juliano/homburg/jazz/The_Slicked_Up_9_s-T_aint_What_You_Do.mp3.wav	jazz
/data0/juliano/homburg/jazz/The_Steve_Darlington_Quintet-Sprechen_Sie_Evil_.mp3.wav	jazz
/data0/juliano/homburg/jazz/The_TCQ-Pressin__Ma_Bit.mp3.wav	jazz
/data0/juliano/homburg/jazz/The_Tippy_Ninja-suspicion_of_innocence.mp3.wav	jazz
/data0/juliano/homburg/jazz/Thirsty_Alley-Boudoir.mp3.wav	jazz
/data0/juliano/homburg/jazz/Tim_McDonald-Aargh_Mr__Scarborough.mp3.wav	jazz
/data0/juliano/homburg/jazz/Too_Much_Coffee-Karen.mp3.wav	jazz
/data0/juliano/homburg/jazz/Trio_Mission-Pirite.mp3.wav	jazz
/data0/juliano/homburg/jazz/Troy_Harmer_Jazz_Trio-11_Tone_Blues.mp3.wav	jazz
/data0/juliano/homburg/jazz/Tuere-More_Than_Time.mp3.wav	jazz
/data0/juliano/homburg/jazz/VBD-Straight_No_Ice.mp3.wav	jazz
/data0/juliano/homburg/jazz/Victor_McClain-Children_of_The_Sun.mp3.wav	jazz
/data0/juliano/homburg/jazz/Vinny_Ray-bONjULU.mp3.wav	jazz
/data0/juliano/homburg/jazz/Vivan_Myhrvold_Lassen-Margaretas_vaggvisa_Isa.mp3.wav	jazz
/data0/juliano/homburg/jazz/Vivan_Myhrvold_Lassen-Vind__vind_lyckliga_vind.mp3.wav	jazz
/data0/juliano/homburg/jazz/Wabi_Sabi-Apathetic_Jazz_Tune.mp3.wav	jazz
/data0/juliano/homburg/jazz/Walbass_LTD_-Eleventy_11.mp3.wav	jazz
/data0/juliano/homburg/jazz/Waterloo_Jazz_Duo-Godnattvisa.mp3.wav	jazz
/data0/juliano/homburg/jazz/ZemZada-Groovy_Jeans.mp3.wav	jazz
/data0/juliano/homburg/jazz/Zen_Bastards-lydia_s_dance.mp3.wav	jazz
/data0/juliano/homburg/jazz/Zen_Bastards-psychotic_larry_vs_the_toaster_oven.mp3.wav	jazz
/data0/juliano/homburg/jazz/ZoneRangers-Mofunculus.mp3.wav	jazz
/data0/juliano/homburg/jazz/ZoneRangers-Seconds_From_Nowhere.mp3.wav	jazz
/data0/juliano/homburg/jazz/ZoneRangers-The_Zone_at_Twighlight.mp3.wav	jazz
/data0/juliano/homburg/jazz/_the_MOVE-Easy.mp3.wav	jazz
/data0/juliano/homburg/jazz/envibronment-Eventually__live_.mp3.wav	jazz
/data0/juliano/homburg/jazz/everett_b__walters-dinner_4___2.mp3.wav	jazz
/data0/juliano/homburg/jazz/flashchudder-OverEasy.mp3.wav	jazz
/data0/juliano/homburg/jazz/gutbucket-Don_t_Fall_on_Dirty_Mary.mp3.wav	jazz
/data0/juliano/homburg/jazz/irene_sage_band-BLUE_TEMPLE.mp3.wav	jazz
/data0/juliano/homburg/jazz/meltdownGreen-traumatic_tensions.mp3.wav	jazz
/data0/juliano/homburg/jazz/mike_D-tonight.mp3.wav	jazz
/data0/juliano/homburg/jazz/mk7-Crabtology.mp3.wav	jazz
/data0/juliano/homburg/jazz/moir-Drifter_on_the_FM.mp3.wav	jazz
/data0/juliano/homburg/jazz/my_tiny_sofa-Jinneyeh.mp3.wav	jazz
/data0/juliano/homburg/jazz/my_tiny_sofa-Seraphim.mp3.wav	jazz
/data0/juliano/homburg/jazz/oj_trio-She_Is_Mine.mp3.wav	jazz
/data0/juliano/homburg/jazz/oj_trio-The_One_For_Me.mp3.wav	jazz
/data0/juliano/homburg/jazz/prospect101-filler.mp3.wav	jazz
/data0/juliano/homburg/jazz/red_clay_trio-autums_leaves__live_at_canturberries_.mp3.wav	jazz
/data0/juliano/homburg/jazz/sub5-For_your_love.mp3.wav	jazz
/data0/juliano/homburg/jazz/sub5-Q_bass.mp3.wav	jazz
/data0/juliano/homburg/jazz/sub5-Something_nice_in_G.mp3.wav	jazz
/data0/juliano/homburg/jazz/sub5-Southside.mp3.wav	jazz
/data0/juliano/homburg/jazz/usra_leedham-it_has_been_said.mp3.wav	jazz
/data0/juliano/homburg/pop/AZWEL-In_Two.mp3.wav	pop
/data0/juliano/homburg/pop/AccoladeUK-Sleep_Tonight.mp3.wav	pop
/data0/juliano/homburg/pop/AccoladeUK-Wish_that_they_could_hear_us.mp3.wav	pop
/data0/juliano/homburg/pop/Adam_Saul_Bloch-Orchard_Drive.mp3.wav	pop
/data0/juliano/homburg/pop/Adrienne_Stiefel-All_I_Know.mp3.wav	pop
/data0/juliano/homburg/pop/Allegra-Skyline.mp3.wav	pop
/data0/juliano/homburg/pop/Allegra-Why.mp3.wav	pop
/data0/juliano/homburg/pop/Amanda_Meza-Here_I_Am.mp3.wav	pop
/data0/juliano/homburg/pop/Amy_Steinberg_Band-Reflections.mp3.wav	pop
/data0/juliano/homburg/pop/Amy_Steinberg_Band-Should_ve_Known.mp3.wav	pop
/data0/juliano/homburg/pop/Andrea_England-Heart_Wide_Open__Eyes_Wide_Shut_.mp3.wav	pop
/data0/juliano/homburg/pop/Anne_Regina-I_Learned_From_You.mp3.wav	pop
/data0/juliano/homburg/pop/Anqui-Eh_lo_eh_la.mp3.wav	pop
/data0/juliano/homburg/pop/Artgeko-Holding.mp3.wav	pop
/data0/juliano/homburg/pop/Arthur_Yoria-P_S_A_.mp3.wav	pop
/data0/juliano/homburg/pop/Aruna-Broken_Circles.mp3.wav	pop
/data0/juliano/homburg/pop/Ave_nue-Free.mp3.wav	pop
/data0/juliano/homburg/pop/Bill_Bairley-Going_Home.mp3.wav	pop
/data0/juliano/homburg/pop/Bryon_Mack-Crazy_World.mp3.wav	pop
/data0/juliano/homburg/pop/Cassidy-Love_You_Like_My_Radio.mp3.wav	pop
/data0/juliano/homburg/pop/Christine_Havrilla-Diamonds.mp3.wav	pop
/data0/juliano/homburg/pop/Cornerstone-End_of_the_Sky.mp3.wav	pop
/data0/juliano/homburg/pop/Cynthias_Brow-I_Wish_I_Had.mp3.wav	pop
/data0/juliano/homburg/pop/DOV-Tired.mp3.wav	pop
/data0/juliano/homburg/pop/Dave_Keats-Everlasting.mp3.wav	pop
/data0/juliano/homburg/pop/Dean_Drouillard-Talk_Me_Up.mp3.wav	pop
/data0/juliano/homburg/pop/Dena_Risha-I_ll_Keep_You.mp3.wav	pop
/data0/juliano/homburg/pop/Dormant_Light-Calisite.mp3.wav	pop
/data0/juliano/homburg/pop/ENTROPY64-Mind_Conditioning.mp3.wav	pop
/data0/juliano/homburg/pop/Electronic_Soul-Freezer_Burn.mp3.wav	pop
/data0/juliano/homburg/pop/EmilyRichards-Surrender.mp3.wav	pop
/data0/juliano/homburg/pop/Erin_Alden-Story_of_the_week.mp3.wav	pop
/data0/juliano/homburg/pop/Fair_Trade-Moonshine.mp3.wav	pop
/data0/juliano/homburg/pop/Fig-The_Good_Together_Brings.mp3.wav	pop
/data0/juliano/homburg/pop/Film-Take_It_All_Away.mp3.wav	pop
/data0/juliano/homburg/pop/Geoff_Byrd-Elusive_Butterfly.mp3.wav	pop
/data0/juliano/homburg/pop/Geoff_Byrd-Frozen.mp3.wav	pop
/data0/juliano/homburg/pop/Gunner-Take_Me_Home.mp3.wav	pop
/data0/juliano/homburg/pop/Head_Patrol-Matter_Of_Time.mp3.wav	pop
/data0/juliano/homburg/pop/Ian_Tanner-Ten_Cartwheels.mp3.wav	pop
/data0/juliano/homburg/pop/James_Albin_Band-Alright.mp3.wav	pop
/data0/juliano/homburg/pop/James_Speer-Blue_Bowl.mp3.wav	pop
/data0/juliano/homburg/pop/Jeepstar-Little_Ocean.mp3.wav	pop
/data0/juliano/homburg/pop/Jeneen-Tell_Me_Right_Now.mp3.wav	pop
/data0/juliano/homburg/pop/Jenna_Drey-Stand_In_Line.mp3.wav	pop
/data0/juliano/homburg/pop/Jenna_Drey-Why___Dance_Version.mp3.wav	pop
/data0/juliano/homburg/pop/Jennifer_Dahl-All_Night.mp3.wav	pop
/data0/juliano/homburg/pop/Jensen-gotta_be_a_better_way.mp3.wav	pop
/data0/juliano/homburg/pop/Jesus_Martini-For_You.mp3.wav	pop
/data0/juliano/homburg/pop/Josh_Fausset-Spruce_Top_Kid.mp3.wav	pop
/data0/juliano/homburg/pop/Julie_Kim-Free.mp3.wav	pop
/data0/juliano/homburg/pop/Karen-Thats_The_Way_It_Is.mp3.wav	pop
/data0/juliano/homburg/pop/Kelly_Johnson-Inner_Beauty.mp3.wav	pop
/data0/juliano/homburg/pop/LEVI-all_the_rules_are_broken.mp3.wav	pop
/data0/juliano/homburg/pop/Lady_Jane_Grey-Twilight.mp3.wav	pop
/data0/juliano/homburg/pop/Larry_Michael_Miller_Band-Never_Make_It_Without_You.mp3.wav	pop
/data0/juliano/homburg/pop/Laura_Song-Higher.mp3.wav	pop
/data0/juliano/homburg/pop/Less_Than_7-rescue_me.mp3.wav	pop
/data0/juliano/homburg/pop/Londra-Nothing_Happened.mp3.wav	pop
/data0/juliano/homburg/pop/Lyndsey_Highlander-Whatcha_Say.mp3.wav	pop
/data0/juliano/homburg/pop/Lyndsey_Highlander-Wonder_Of_The_One.mp3.wav	pop
/data0/juliano/homburg/pop/Lyndsey_Highlander-You_Are_My_Everything.mp3.wav	pop
/data0/juliano/homburg/pop/Lynn_Harrison-Room_to_Love.mp3.wav	pop
/data0/juliano/homburg/pop/MX1010-Eyes.mp3.wav	pop
/data0/juliano/homburg/pop/Marc_Trachtenberg-Lost_in_Dreams.mp3.wav	pop
/data0/juliano/homburg/pop/March_Hares-Clock_Keeps_Ticking.mp3.wav	pop
/data0/juliano/homburg/pop/Martin_Gallop-Stuck_On_You.mp3.wav	pop
/data0/juliano/homburg/pop/Matt_McElroy_and_Laura_Aquilino-If_Id_Only_Known.mp3.wav	pop
/data0/juliano/homburg/pop/Miracle_Vendor-Overdue.mp3.wav	pop
/data0/juliano/homburg/pop/Moodswing-Gigalo.mp3.wav	pop
/data0/juliano/homburg/pop/Natasha-Helpless.mp3.wav	pop
/data0/juliano/homburg/pop/Outer_Space_Love_Project-Rollercoaster.mp3.wav	pop
/data0/juliano/homburg/pop/PJ_Smith-Beauty_Queen.mp3.wav	pop
/data0/juliano/homburg/pop/Pat_Walsh-Supersonic_Girl.mp3.wav	pop
/data0/juliano/homburg/pop/Paul_Sforza-Over_and_Over.mp3.wav	pop
/data0/juliano/homburg/pop/Poppa_Lawrence-Colder_Night.mp3.wav	pop
/data0/juliano/homburg/pop/Raining_Jane-These_Walls.mp3.wav	pop
/data0/juliano/homburg/pop/Rebeka_Reed-Pharaoh_s_Daughter___Final_Version.mp3.wav	pop
/data0/juliano/homburg/pop/Resisters-Made_for_you.mp3.wav	pop
/data0/juliano/homburg/pop/Resisters-Only_Fools.mp3.wav	pop
/data0/juliano/homburg/pop/Robot_Popstar-Adagio_Insane.mp3.wav	pop
/data0/juliano/homburg/pop/SAHINA-AOLG___Art_Of_Letting_Go.mp3.wav	pop
/data0/juliano/homburg/pop/Sacred_Raisin_Cakes-WaterPots.mp3.wav	pop
/data0/juliano/homburg/pop/Sandra_Carlucci-Not_Feelin__It.mp3.wav	pop
/data0/juliano/homburg/pop/Sarah_Sharp-Run.mp3.wav	pop
/data0/juliano/homburg/pop/Scotland_Yard-Wake_Up.mp3.wav	pop
/data0/juliano/homburg/pop/Sepiamusic-Ease_Me.mp3.wav	pop
/data0/juliano/homburg/pop/Sepiamusic-Fall_Into_Me.mp3.wav	pop
/data0/juliano/homburg/pop/Slow_Lorries-Elevator__6.mp3.wav	pop
/data0/juliano/homburg/pop/Sorci___Tomich-Linger.mp3.wav	pop
/data0/juliano/homburg/pop/StarBaby-Take_What_the_Music_Gives_You__TWTMGY_.mp3.wav	pop
/data0/juliano/homburg/pop/Stucky-Cundo_Llegara.mp3.wav	pop
/data0/juliano/homburg/pop/SugarBox-Skin_Tight.mp3.wav	pop
/data0/juliano/homburg/pop/Sugarbuzz-Born_Again.mp3.wav	pop
/data0/juliano/homburg/pop/Symphony_in_DeMeanor-Farewell_Marissa.mp3.wav	pop
/data0/juliano/homburg/pop/Symphony_in_DeMeanor-Lonely_Fool.mp3.wav	pop
/data0/juliano/homburg/pop/Tad_Dreis-Good_For_You.mp3.wav	pop
/data0/juliano/homburg/pop/Taxi_Doll-Waiting.mp3.wav	pop
/data0/juliano/homburg/pop/The_Dent-Fantastic.mp3.wav	pop
/data0/juliano/homburg/pop/The_Sun_Kings-Lullaby.mp3.wav	pop
/data0/juliano/homburg/pop/Trancenden-don_t.mp3.wav	pop
/data0/juliano/homburg/pop/Virginia-Carry_Me_Home.mp3.wav	pop
/data0/juliano/homburg/pop/VortexUSA-The_Only_Thing_is_Love.mp3.wav	pop
/data0/juliano/homburg/pop/WATERFRONT-A_song_you_never_hear.mp3.wav	pop
/data0/juliano/homburg/pop/Wushu-Weightless.mp3.wav	pop
/data0/juliano/homburg/pop/Zuzu-Constellation.mp3.wav	pop
/data0/juliano/homburg/pop/boysengirls-same_song__sad_end.mp3.wav	pop
/data0/juliano/homburg/pop/christa_couture-day_4.mp3.wav	pop
/data0/juliano/homburg/pop/dePresleys-Operator.mp3.wav	pop
/data0/juliano/homburg/pop/delaware-Everything_Changes.mp3.wav	pop
/data0/juliano/homburg/pop/doublesixx-Out_of_love.mp3.wav	pop
/data0/juliano/homburg/pop/melissa_warner_band-brown_eyes.mp3.wav	pop
/data0/juliano/homburg/pop/outerdrive-Fly.mp3.wav	pop
/data0/juliano/homburg/pop/puckett_-Last_Year.mp3.wav	pop
/data0/juliano/homburg/pop/roy_joseph-here_in_L_A_.mp3.wav	pop
/data0/juliano/homburg/pop/weaklazyliar-Old_Blue_Suit.mp3.wav	pop
/data0/juliano/homburg/raphiphop/1ONE1___the_advent_-Not_Us__so_long_ago_.mp3.wav	raphiphop
/data0/juliano/homburg/raphiphop/211Entertainment-First_2_Blast.mp3.wav	raphiphop
/data0/juliano/homburg/raphiphop/AD___Jack_Cracker__the_Crest_-High_School.mp3.wav	raphiphop
/data0/juliano/homburg/raphiphop/AD___Jack_Cracker__the_Crest_-I_Like_the_Dark.mp3.wav	raphiphop
/data0/juliano/homburg/raphiphop/AK_MC_s-This_is_not_a_test.mp3.wav	raphiphop
/data0/juliano/homburg/raphiphop/Abyss_Networks-It_s_Always_Live.mp3.wav	raphiphop
/data0/juliano/homburg/raphiphop/Anialation-UNITED_LIEZ.mp3.wav	raphiphop
/data0/juliano/homburg/raphiphop/Apakacrakers-Hotter.mp3.wav	raphiphop
/data0/juliano/homburg/raphiphop/Apakacrakers-The_Interview.mp3.wav	raphiphop
/data0/juliano/homburg/raphiphop/ApostleDZack-Da_Righteous_Kidd.mp3.wav	raphiphop
/data0/juliano/homburg/raphiphop/ApostleDZack-Next_2_U.mp3.wav	raphiphop
/data0/juliano/homburg/raphiphop/Area_51_MC_s-Area_51_Show_Sampler.mp3.wav	raphiphop
/data0/juliano/homburg/raphiphop/Arkatext-Commercial_Cut.mp3.wav	raphiphop
/data0/juliano/homburg/raphiphop/Arkatext-The_Message.mp3.wav	raphiphop
/data0/juliano/homburg/raphiphop/Artistic_Anarchists-Backs_Off_The_Wall.mp3.wav	raphiphop
/data0/juliano/homburg/raphiphop/Artistic_Anarchists-Don_t_F__With_Us.mp3.wav	raphiphop
/data0/juliano/homburg/raphiphop/Assasyn_Dynasty-Vaccination.mp3.wav	raphiphop
/data0/juliano/homburg/raphiphop/Azael-Take_it_back.mp3.wav	raphiphop
/data0/juliano/homburg/raphiphop/BISHOP_Brigante-Communicate.mp3.wav	raphiphop
/data0/juliano/homburg/raphiphop/BISHOP_Brigante-That_s_The_Way.mp3.wav	raphiphop
/data0/juliano/homburg/raphiphop/BMS-Joker_s.mp3.wav	raphiphop
/data0/juliano/homburg/raphiphop/BU_BONIC_INC_-Relax_Yourself.mp3.wav	raphiphop
/data0/juliano/homburg/raphiphop/B_Brock-2_N_The_Morning__lt_uncut_gt_.mp3.wav	raphiphop
/data0/juliano/homburg/raphiphop/B_Brock-Stressed_N_Depressed.mp3.wav	raphiphop
/data0/juliano/homburg/raphiphop/Basement-Natural.mp3.wav	raphiphop
/data0/juliano/homburg/raphiphop/Bdot_C-Get_Down_baby_.mp3.wav	raphiphop
/data0/juliano/homburg/raphiphop/Beneficial-Real_Life.mp3.wav	raphiphop
/data0/juliano/homburg/raphiphop/Blackwell_a_k_a_Da_ILL_Malotta-The_Devil_is_Trying_to_Get_the_Best_of_Me.mp3.wav	raphiphop
/data0/juliano/homburg/raphiphop/Blue_Discourse-Scotch_on_the_Rocks.mp3.wav	raphiphop
/data0/juliano/homburg/raphiphop/Booda_Angels-This_Is_It_featuring_Eddie_Kain.mp3.wav	raphiphop
/data0/juliano/homburg/raphiphop/Brassknucks-Saddle_Up.mp3.wav	raphiphop
/data0/juliano/homburg/raphiphop/Brassknucks-Soulful_Spirit.mp3.wav	raphiphop
/data0/juliano/homburg/raphiphop/Brownz_Family-Artificial_Life.mp3.wav	raphiphop
/data0/juliano/homburg/raphiphop/Brownz_Family-Flying_Ova_.mp3.wav	raphiphop
/data0/juliano/homburg/raphiphop/Brownz_Family-Tunes_4da_Spirit.mp3.wav	raphiphop
/data0/juliano/homburg/raphiphop/Butterson_L_sworth-Don_t_Know_Where_To_Go.mp3.wav	raphiphop
/data0/juliano/homburg/raphiphop/Butterson_L_sworth-F_the_Law.mp3.wav	raphiphop
/data0/juliano/homburg/raphiphop/CANDEE_REIGN-MY_DEBUT.mp3.wav	raphiphop
/data0/juliano/homburg/raphiphop/CHILDREN_OF_THE_FOG-Innocence_Lost.mp3.wav	raphiphop
/data0/juliano/homburg/raphiphop/COLABO-Back_To_Tha_Castle.mp3.wav	raphiphop
/data0/juliano/homburg/raphiphop/CarD-The_Rude_Awakening.mp3.wav	raphiphop
/data0/juliano/homburg/raphiphop/Cashada-Why_.mp3.wav	raphiphop
/data0/juliano/homburg/raphiphop/Central_Plains-Contact.mp3.wav	raphiphop
/data0/juliano/homburg/raphiphop/Charli_Funk-Bump.mp3.wav	raphiphop
/data0/juliano/homburg/raphiphop/Chris_Rel-The_Messenger.mp3.wav	raphiphop
/data0/juliano/homburg/raphiphop/Cold_Duck_Complex-Wake_Up.mp3.wav	raphiphop
/data0/juliano/homburg/raphiphop/Creative_Nature-Giggles_And_Kicks.mp3.wav	raphiphop
/data0/juliano/homburg/raphiphop/Critical_Mindz-Good_2_Be_Wrong.mp3.wav	raphiphop
/data0/juliano/homburg/raphiphop/DAVID_CHAMPION-_HERE_WE_GO_AGAIN_.mp3.wav	raphiphop
/data0/juliano/homburg/raphiphop/DGR_Melange-Hot_.mp3.wav	raphiphop
/data0/juliano/homburg/raphiphop/D_O_-This_Love.mp3.wav	raphiphop
/data0/juliano/homburg/raphiphop/Da_Gooniez-All_4_You.mp3.wav	raphiphop
/data0/juliano/homburg/raphiphop/Dangerous_Affiliation-Dont_Seem_Right__Wanna_Be_.mp3.wav	raphiphop
/data0/juliano/homburg/raphiphop/Dangerous_Affiliation-Sinfull_Nature.mp3.wav	raphiphop
/data0/juliano/homburg/raphiphop/Dangerous_Affiliation-confrontations.mp3.wav	raphiphop
/data0/juliano/homburg/raphiphop/Dejanero-Ballin_.mp3.wav	raphiphop
/data0/juliano/homburg/raphiphop/Devante_Saunders-Architect.mp3.wav	raphiphop
/data0/juliano/homburg/raphiphop/Devante_Saunders-Game_On_Lock.mp3.wav	raphiphop
/data0/juliano/homburg/raphiphop/Devante_Saunders-Oh_No.mp3.wav	raphiphop
/data0/juliano/homburg/raphiphop/Devon_Maya-Packed_up.mp3.wav	raphiphop
/data0/juliano/homburg/raphiphop/Digitally_Synchronized_Analog-SPLINTER.mp3.wav	raphiphop
/data0/juliano/homburg/raphiphop/Divine_MC-I_Hear_Ya_Cries.mp3.wav	raphiphop
/data0/juliano/homburg/raphiphop/Divine_MC-State_Of_Misery.mp3.wav	raphiphop
/data0/juliano/homburg/raphiphop/DraMatiQue-Be___.mp3.wav	raphiphop
/data0/juliano/homburg/raphiphop/DraMatiQue___BenFlowz-Sky_High.mp3.wav	raphiphop
/data0/juliano/homburg/raphiphop/DraMatiQue___BenFlowz-Spellbound.mp3.wav	raphiphop
/data0/juliano/homburg/raphiphop/DraMatiQue___BenFlowz-Wonderful.mp3.wav	raphiphop
/data0/juliano/homburg/raphiphop/Dynamic_Certified-How_Come.mp3.wav	raphiphop
/data0/juliano/homburg/raphiphop/Element_of_Chaos-Feelin__Right_f__Legion_Lord___Felicia.mp3.wav	raphiphop
/data0/juliano/homburg/raphiphop/Element_of_Chaos-NBConnexion_Mixtape_Exclusive.mp3.wav	raphiphop
/data0/juliano/homburg/raphiphop/Element_of_Chaos-Weapon_of_Choice_f__Legion_Lord.mp3.wav	raphiphop
/data0/juliano/homburg/raphiphop/Eric_Campbell-God_s_Bad_Rap.mp3.wav	raphiphop
/data0/juliano/homburg/raphiphop/FALLEN_ANGELZ-LIFE.mp3.wav	raphiphop
/data0/juliano/homburg/raphiphop/FDAP_-Alienated.mp3.wav	raphiphop
/data0/juliano/homburg/raphiphop/F_N_I_C_-Mo_Dime.mp3.wav	raphiphop
/data0/juliano/homburg/raphiphop/Fatality_Records___Entertainment-_Seasons_Change__G_Nice.mp3.wav	raphiphop
/data0/juliano/homburg/raphiphop/Flipside-Creepin__In.mp3.wav	raphiphop
/data0/juliano/homburg/raphiphop/Fokissed-Fokissed___Born_to_Be_a_Star.mp3.wav	raphiphop
/data0/juliano/homburg/raphiphop/Fokissed-Fokissed___Now_THAT_s_Gangsta.mp3.wav	raphiphop
/data0/juliano/homburg/raphiphop/Fokissed-Fokissed___The_Following_Messages.mp3.wav	raphiphop
/data0/juliano/homburg/raphiphop/Fokissed-Fokissed___You_Must_Be_Mistaken.mp3.wav	raphiphop
/data0/juliano/homburg/raphiphop/Fokissed-Fokissed_w_BlackWolff__The_Lord_s_Other_Prayer.mp3.wav	raphiphop
/data0/juliano/homburg/raphiphop/Freeloadas_Productions_Inc_-Follow_Me.mp3.wav	raphiphop
/data0/juliano/homburg/raphiphop/Freeloadas_Productions_Inc_-Strip_Pole_Blues.mp3.wav	raphiphop
/data0/juliano/homburg/raphiphop/Front_liners-Proper_english.mp3.wav	raphiphop
/data0/juliano/homburg/raphiphop/Fulani-Lady_Friend.mp3.wav	raphiphop
/data0/juliano/homburg/raphiphop/Fulani-Scandelous.mp3.wav	raphiphop
/data0/juliano/homburg/raphiphop/Full_Clip-Reality_Rap.mp3.wav	raphiphop
/data0/juliano/homburg/raphiphop/GENOCIDE-GET_DAT_.mp3.wav	raphiphop
/data0/juliano/homburg/raphiphop/GENOCIDE-Spit_To_Death.mp3.wav	raphiphop
/data0/juliano/homburg/raphiphop/GENOCIDE-Strive.mp3.wav	raphiphop
/data0/juliano/homburg/raphiphop/G_Band_Free-Average_MC.mp3.wav	raphiphop
/data0/juliano/homburg/raphiphop/G_Loe-I_Might_Be.mp3.wav	raphiphop
/data0/juliano/homburg/raphiphop/Ginnis-Compete_W__Few.mp3.wav	raphiphop
/data0/juliano/homburg/raphiphop/Gym_Class_Heroes-Decrepit_Bricks.mp3.wav	raphiphop
/data0/juliano/homburg/raphiphop/HONDO-My_Life.mp3.wav	raphiphop
/data0/juliano/homburg/raphiphop/HiTec-Got_It_Locked.mp3.wav	raphiphop
/data0/juliano/homburg/raphiphop/Hillz-Walk_A_Mile.mp3.wav	raphiphop
/data0/juliano/homburg/raphiphop/Hipacalypse-Keep_it_Underground.mp3.wav	raphiphop
/data0/juliano/homburg/raphiphop/Hipacalypse-Other_shit.mp3.wav	raphiphop
/data0/juliano/homburg/raphiphop/Hud_Hustlas-All_I_Want_feat_Franchise.mp3.wav	raphiphop
/data0/juliano/homburg/raphiphop/Hud_Hustlas-Dead_Inside_feat__Wordz__Tha_1st_Sun__Mill_Dollas_.mp3.wav	raphiphop
/data0/juliano/homburg/raphiphop/ICM-Breaking_Point_Second_Thought.mp3.wav	raphiphop
/data0/juliano/homburg/raphiphop/ICM-Monster_Hand.mp3.wav	raphiphop
/data0/juliano/homburg/raphiphop/ICM-Take_Off_Malicious.mp3.wav	raphiphop
/data0/juliano/homburg/raphiphop/ILL_SKILLZ-Street_Knowledge.mp3.wav	raphiphop
/data0/juliano/homburg/raphiphop/I_C-I_Drop_Jewels.mp3.wav	raphiphop
/data0/juliano/homburg/raphiphop/I_C-Keep_it_movin_.mp3.wav	raphiphop
/data0/juliano/homburg/raphiphop/I_C-paperchase.mp3.wav	raphiphop
/data0/juliano/homburg/raphiphop/Illanoiz-Blood_on_a_Leaf.mp3.wav	raphiphop
/data0/juliano/homburg/raphiphop/Indigenous_Womb-Away.mp3.wav	raphiphop
/data0/juliano/homburg/raphiphop/Indigenous_Womb-I_ve_Learned.mp3.wav	raphiphop
/data0/juliano/homburg/raphiphop/Inov8-Inovationz.mp3.wav	raphiphop
/data0/juliano/homburg/raphiphop/Insane-Bleed_Ya_Block.mp3.wav	raphiphop
/data0/juliano/homburg/raphiphop/Insane-Phone_Killa_s_Feat__Ray.mp3.wav	raphiphop
/data0/juliano/homburg/raphiphop/Intelligence_Quotient-I_love_Life.mp3.wav	raphiphop
/data0/juliano/homburg/raphiphop/J_Suede-Hope_You_Understand.mp3.wav	raphiphop
/data0/juliano/homburg/raphiphop/Jahn_Jahn-Hangin__Tonight.mp3.wav	raphiphop
/data0/juliano/homburg/raphiphop/Jay_Bizzy-Just_When_You_Thought.mp3.wav	raphiphop
/data0/juliano/homburg/raphiphop/Jay_Bizzy-Seven_Feet_Tall.mp3.wav	raphiphop
/data0/juliano/homburg/raphiphop/Jesse_Calico-All_about_Me.mp3.wav	raphiphop
/data0/juliano/homburg/raphiphop/Joe_Dryer-City_of_Farrell.mp3.wav	raphiphop
/data0/juliano/homburg/raphiphop/JointMethod-The_Right_Direction.mp3.wav	raphiphop
/data0/juliano/homburg/raphiphop/Jokr-Standin_On_Tha_Corna.mp3.wav	raphiphop
/data0/juliano/homburg/raphiphop/KENDO-Everlasting.mp3.wav	raphiphop
/data0/juliano/homburg/raphiphop/KENDO-No_Hook.mp3.wav	raphiphop
/data0/juliano/homburg/raphiphop/KNOWLEDGE_BROWN-For_every_action.mp3.wav	raphiphop
/data0/juliano/homburg/raphiphop/KNOWLEDGE_BROWN-aint_no_I_in_team.mp3.wav	raphiphop
/data0/juliano/homburg/raphiphop/KRISIS_MAXIMUS-SAYERS_SINNERS.mp3.wav	raphiphop
/data0/juliano/homburg/raphiphop/Kae-Born_Alone__Die_Alone.mp3.wav	raphiphop
/data0/juliano/homburg/raphiphop/Kae-Live_This_Life.mp3.wav	raphiphop
/data0/juliano/homburg/raphiphop/Karlos_Rossi-Ewwe.mp3.wav	raphiphop
/data0/juliano/homburg/raphiphop/Kas-Here__Feat__Sarah_Taylor_.mp3.wav	raphiphop
/data0/juliano/homburg/raphiphop/Kas-Man_Apart.mp3.wav	raphiphop
/data0/juliano/homburg/raphiphop/KatchPhraze-Eye_Can_See.mp3.wav	raphiphop
/data0/juliano/homburg/raphiphop/KatchPhraze-Peep_Game.mp3.wav	raphiphop
/data0/juliano/homburg/raphiphop/Khalito-Fear.mp3.wav	raphiphop
/data0/juliano/homburg/raphiphop/Khalito-Spoiled.mp3.wav	raphiphop
/data0/juliano/homburg/raphiphop/KnockSmith_Era-Read_My_Lips.mp3.wav	raphiphop
/data0/juliano/homburg/raphiphop/KnomatiK-3_Raw_Elements.mp3.wav	raphiphop
/data0/juliano/homburg/raphiphop/Knuckleheadbanga-Last_Call.mp3.wav	raphiphop
/data0/juliano/homburg/raphiphop/Kold_Kut_Productions-Im_So_Lonely.mp3.wav	raphiphop
/data0/juliano/homburg/raphiphop/Konfuzion-Creepin_.mp3.wav	raphiphop
/data0/juliano/homburg/raphiphop/Konstant-Aye_Yo___.mp3.wav	raphiphop
/data0/juliano/homburg/raphiphop/Krumbz-Jerzy_Kidz__Album_Version_.mp3.wav	raphiphop
/data0/juliano/homburg/raphiphop/LOULAW-Hip_Hop_2004.mp3.wav	raphiphop
/data0/juliano/homburg/raphiphop/L_A_W_1-They_Want_s_Nothing.mp3.wav	raphiphop
/data0/juliano/homburg/raphiphop/LandLordz-The_Struggle.mp3.wav	raphiphop
/data0/juliano/homburg/raphiphop/LastChild427-My_Shoes.mp3.wav	raphiphop
/data0/juliano/homburg/raphiphop/Latino_Saint-MAKE_YA.mp3.wav	raphiphop
/data0/juliano/homburg/raphiphop/Lee_Williams___The_Square_Egg-Dream__Featuring_Antonia_Jenae_.mp3.wav	raphiphop
/data0/juliano/homburg/raphiphop/Leroy_Smokes-Don_t_Seem_2_Hear_Me_.mp3.wav	raphiphop
/data0/juliano/homburg/raphiphop/Leroy_Smokes-Lo_Fi.mp3.wav	raphiphop
/data0/juliano/homburg/raphiphop/Leroy_Smokes-Step_Right_Up_.mp3.wav	raphiphop
/data0/juliano/homburg/raphiphop/Leyenda_Urbana-Why_.mp3.wav	raphiphop
/data0/juliano/homburg/raphiphop/Live_Vibe-Profile.mp3.wav	raphiphop
/data0/juliano/homburg/raphiphop/Lords_Of_Tha_Fly-Whateva.mp3.wav	raphiphop
/data0/juliano/homburg/raphiphop/M8T-You_Wanna.mp3.wav	raphiphop
/data0/juliano/homburg/raphiphop/MB_Twinz-Where_Would_I_Go_Next.mp3.wav	raphiphop
/data0/juliano/homburg/raphiphop/MEDU_NETR-Live_Yo_Life_.mp3.wav	raphiphop
/data0/juliano/homburg/raphiphop/MISMARIE-life_can_be.mp3.wav	raphiphop
/data0/juliano/homburg/raphiphop/MS_DIAMOND-Get_Crunk.mp3.wav	raphiphop
/data0/juliano/homburg/raphiphop/Malak_Productions-Throwback__feat_Kae_Daq_.mp3.wav	raphiphop
/data0/juliano/homburg/raphiphop/Masters_of_the_U_N_I_verse-The_American_Dream.mp3.wav	raphiphop
/data0/juliano/homburg/raphiphop/Masters_of_the_U_N_I_verse-Unprecedented_w_Chops__Mountain_Bros_.mp3.wav	raphiphop
/data0/juliano/homburg/raphiphop/Masters_of_the_U_N_I_verse-Who_s_This_.mp3.wav	raphiphop
/data0/juliano/homburg/raphiphop/Mento_Buru-Chillin__with_Mento__W__TRACC_ADDICTS_.mp3.wav	raphiphop
/data0/juliano/homburg/raphiphop/Mista_Sniper-RISE.mp3.wav	raphiphop
/data0/juliano/homburg/raphiphop/Mista_Sniper-S_N_I_P_E.mp3.wav	raphiphop
/data0/juliano/homburg/raphiphop/Mr__Biko-Sleep_Son.mp3.wav	raphiphop
/data0/juliano/homburg/raphiphop/Mr__Bugsy-Look_at_me_now.mp3.wav	raphiphop
/data0/juliano/homburg/raphiphop/MuZigLab-This_Is_How_We__Hold_It_Down_.mp3.wav	raphiphop
/data0/juliano/homburg/raphiphop/Myriad-Front_2_Back.mp3.wav	raphiphop
/data0/juliano/homburg/raphiphop/NFINITTI-SHOW_ME.mp3.wav	raphiphop
/data0/juliano/homburg/raphiphop/Nameless_Strangers-The_Way_I_Shine.mp3.wav	raphiphop
/data0/juliano/homburg/raphiphop/Napolean-Get_Your_Gun.mp3.wav	raphiphop
/data0/juliano/homburg/raphiphop/Naybahud_F_O_L_K_S-the_Essense.mp3.wav	raphiphop
/data0/juliano/homburg/raphiphop/Nero_Ceasar_and_Peace_of_Mind-Saul.mp3.wav	raphiphop
/data0/juliano/homburg/raphiphop/Nesta_Studio_Barabbas_Free-Witnessing__Hip_Hop_.mp3.wav	raphiphop
/data0/juliano/homburg/raphiphop/Nexxis-Blaze.mp3.wav	raphiphop
/data0/juliano/homburg/raphiphop/Noize_Makers-Rap_Star.mp3.wav	raphiphop
/data0/juliano/homburg/raphiphop/Nomad_Exploraz-Fear_Nobody.mp3.wav	raphiphop
/data0/juliano/homburg/raphiphop/Nomad_Exploraz-New_Raw_Order.mp3.wav	raphiphop
/data0/juliano/homburg/raphiphop/Nomad_Exploraz-No_Dancing.mp3.wav	raphiphop
/data0/juliano/homburg/raphiphop/OCD_Productions-Out_cha_Element.mp3.wav	raphiphop
/data0/juliano/homburg/raphiphop/OFFsides-One_Rhyme__feat_DR_one_.mp3.wav	raphiphop
/data0/juliano/homburg/raphiphop/OFFsides-Turn_it_up.mp3.wav	raphiphop
/data0/juliano/homburg/raphiphop/OUT_THA_TRUNK-PRISONER_023.mp3.wav	raphiphop
/data0/juliano/homburg/raphiphop/Opie_Hicks_and_The_Elements-Bud_Light.mp3.wav	raphiphop
/data0/juliano/homburg/raphiphop/Opie_Hicks_and_The_Elements-Come_Back.mp3.wav	raphiphop
/data0/juliano/homburg/raphiphop/Optimus_Prime_aka_Diceptagon_The_Malignant-Cannibal_Nigguz.mp3.wav	raphiphop
/data0/juliano/homburg/raphiphop/Optimus_Prime_aka_Diceptagon_The_Malignant-It_s_my_turn.mp3.wav	raphiphop
/data0/juliano/homburg/raphiphop/Optimus_Prime_aka_Diceptagon_The_Malignant-My_Blackbook.mp3.wav	raphiphop
/data0/juliano/homburg/raphiphop/Origin_Nile-How_It_Was.mp3.wav	raphiphop
/data0/juliano/homburg/raphiphop/Origin_Nile-Safe_To_Feel_feat__Sanashine.mp3.wav	raphiphop
/data0/juliano/homburg/raphiphop/Origin_Nile-Trapped.mp3.wav	raphiphop
/data0/juliano/homburg/raphiphop/P1_presents-Come_n_get_me.mp3.wav	raphiphop
/data0/juliano/homburg/raphiphop/Pagemasta-Armeggedon.mp3.wav	raphiphop
/data0/juliano/homburg/raphiphop/Pete_Smith-Respect.mp3.wav	raphiphop
/data0/juliano/homburg/raphiphop/Planet_s_Audible-Going_Outside.mp3.wav	raphiphop
/data0/juliano/homburg/raphiphop/Playboy-He_s_so_fresh__remix_.mp3.wav	raphiphop
/data0/juliano/homburg/raphiphop/Poetic_Alchemy-2033.mp3.wav	raphiphop
/data0/juliano/homburg/raphiphop/Pokafase-Nobody.mp3.wav	raphiphop
/data0/juliano/homburg/raphiphop/Quarta-I_m_Not_Your_Girl.mp3.wav	raphiphop
/data0/juliano/homburg/raphiphop/Quarta-Quarta_s_Here.mp3.wav	raphiphop
/data0/juliano/homburg/raphiphop/RAhiphop-Gutter__.mp3.wav	raphiphop
/data0/juliano/homburg/raphiphop/Restoring_Poetry_in_Music-Play_Your_Part.mp3.wav	raphiphop
/data0/juliano/homburg/raphiphop/Restoring_Poetry_in_Music-Poetry_Bum.mp3.wav	raphiphop
/data0/juliano/homburg/raphiphop/Revanon-Personal.mp3.wav	raphiphop
/data0/juliano/homburg/raphiphop/Rk-Down_for_Mine.mp3.wav	raphiphop
/data0/juliano/homburg/raphiphop/Rk-Exclusive.mp3.wav	raphiphop
/data0/juliano/homburg/raphiphop/Rk-Home_of_the_Brave.mp3.wav	raphiphop
/data0/juliano/homburg/raphiphop/Rk-Return.mp3.wav	raphiphop
/data0/juliano/homburg/raphiphop/Rowdee_Black_Giants-TURN_YOU_OUT.mp3.wav	raphiphop
/data0/juliano/homburg/raphiphop/Rowdee_Black_Giants-Two_For_All.mp3.wav	raphiphop
/data0/juliano/homburg/raphiphop/Rowdee_Black_Giants-Uncontestable.mp3.wav	raphiphop
/data0/juliano/homburg/raphiphop/Ruffian_Squad-Lurk.mp3.wav	raphiphop
/data0/juliano/homburg/raphiphop/Rusty_Chains-My_Year.mp3.wav	raphiphop
/data0/juliano/homburg/raphiphop/SET_4_LIFE_ENTERTAINMENT_PRESENTS_BLISS-CAN_T_QUIT__I_M_ADDICTED.mp3.wav	raphiphop
/data0/juliano/homburg/raphiphop/SET_4_LIFE_ENTERTAINMENT_PRESENTS_BLISS-That_s_My_Song_BY_BLISS.mp3.wav	raphiphop
/data0/juliano/homburg/raphiphop/SET_4_LIFE_ENTERTAINMENT_PRESENTS_BLISS-WHAT_THE_HOOD_BE_SAYIN__by_BLISS.mp3.wav	raphiphop
/data0/juliano/homburg/raphiphop/SIN___Sinister_Child__-Da_Kingdom.mp3.wav	raphiphop
/data0/juliano/homburg/raphiphop/SIN___Sinister_Child__-Lord_Please_Help_Me.mp3.wav	raphiphop
/data0/juliano/homburg/raphiphop/SIN___Sinister_Child__-RAGE.mp3.wav	raphiphop
/data0/juliano/homburg/raphiphop/SIN___Sinister_Child__-Sit_n_On_Top_of_The_World.mp3.wav	raphiphop
/data0/juliano/homburg/raphiphop/SLIMM_NADIR-U_GOT_IT_ALL_WRONG.mp3.wav	raphiphop
/data0/juliano/homburg/raphiphop/Seville-Act_Up_feat__Shawty_Red.mp3.wav	raphiphop
/data0/juliano/homburg/raphiphop/Shadcore-Bounce_To_The_Struggle.mp3.wav	raphiphop
/data0/juliano/homburg/raphiphop/Shadcore-In_My_System.mp3.wav	raphiphop
/data0/juliano/homburg/raphiphop/Shakespeare-Right_Now__Clean_.mp3.wav	raphiphop
/data0/juliano/homburg/raphiphop/Shawn_Elliot_aka_Verble-Gotta_Go.mp3.wav	raphiphop
/data0/juliano/homburg/raphiphop/Slakah_Tha_BeatChild-Take_a_look_in_My_Eyes.mp3.wav	raphiphop
/data0/juliano/homburg/raphiphop/SlimChance_N_Monstar-maryjane.mp3.wav	raphiphop
/data0/juliano/homburg/raphiphop/Soulviet_Union-Fix_Your_Face.mp3.wav	raphiphop
/data0/juliano/homburg/raphiphop/Sound_Science_Entertainment-F_D_I_C.mp3.wav	raphiphop
/data0/juliano/homburg/raphiphop/Southerndrawl-Kick_Rocks.mp3.wav	raphiphop
/data0/juliano/homburg/raphiphop/Split2nd_Entertainment-Anything_You_Want___Axis.mp3.wav	raphiphop
/data0/juliano/homburg/raphiphop/Split2nd_Entertainment-Day_To_Day___Cypher_Complete.mp3.wav	raphiphop
/data0/juliano/homburg/raphiphop/Split2nd_Entertainment-Drop_It___F_A___Feat__Nish_.mp3.wav	raphiphop
/data0/juliano/homburg/raphiphop/Split2nd_Entertainment-Paradise___Wisper_s__Featuring_Kymm_.mp3.wav	raphiphop
/data0/juliano/homburg/raphiphop/Steve_Witz-Diatribe.mp3.wav	raphiphop
/data0/juliano/homburg/raphiphop/StickFiggaz-Musik.mp3.wav	raphiphop
/data0/juliano/homburg/raphiphop/StickFiggaz-What_cha_doin_.mp3.wav	raphiphop
/data0/juliano/homburg/raphiphop/Storm_Trooperz-Rains_Falling.mp3.wav	raphiphop
/data0/juliano/homburg/raphiphop/Strange_Fruit-Broken_Ropes.mp3.wav	raphiphop
/data0/juliano/homburg/raphiphop/Street_Kingz__LOULAW-ASK_YOURSELF.mp3.wav	raphiphop
/data0/juliano/homburg/raphiphop/Street_Kingz__LOULAW-DRINK_ON_US.mp3.wav	raphiphop
/data0/juliano/homburg/raphiphop/Street_Kingz__LOULAW-It_s_a_War_going_on.mp3.wav	raphiphop
/data0/juliano/homburg/raphiphop/THA_INVASION-Streets_Are_Watchin_.mp3.wav	raphiphop
/data0/juliano/homburg/raphiphop/THE_B_M_C-EXPRESSIONZ.mp3.wav	raphiphop
/data0/juliano/homburg/raphiphop/THE_LEAGUE_OF_EXTRAORDINARY_GENTLEMEN-Move_On.mp3.wav	raphiphop
/data0/juliano/homburg/raphiphop/THOROBRED-Kryin__Pain__The_Mixtape_Edition_.mp3.wav	raphiphop
/data0/juliano/homburg/raphiphop/THOROBRED-Mic_Check__A_Lesson_In_Breath_Control_.mp3.wav	raphiphop
/data0/juliano/homburg/raphiphop/TYCE-GONE_WIT_DAT.mp3.wav	raphiphop
/data0/juliano/homburg/raphiphop/T_Blake-In_My_Basement.mp3.wav	raphiphop
/data0/juliano/homburg/raphiphop/T_RONE-NO_TURNING_BACK.mp3.wav	raphiphop
/data0/juliano/homburg/raphiphop/T_RONE-Picture_Life.mp3.wav	raphiphop
/data0/juliano/homburg/raphiphop/Terrell_Skilz-How_Many_Hearts.mp3.wav	raphiphop
/data0/juliano/homburg/raphiphop/The_Blue_Room-3_Minutes.mp3.wav	raphiphop
/data0/juliano/homburg/raphiphop/The_Element_of_Chaos-What_s_Wrong__f__Legion_Lord.mp3.wav	raphiphop
/data0/juliano/homburg/raphiphop/The_Rypist-Unlucky.mp3.wav	raphiphop
/data0/juliano/homburg/raphiphop/The_Soulja_of_Black_Souls-All_4_Love.mp3.wav	raphiphop
/data0/juliano/homburg/raphiphop/Three_Levels_of_Genius__3LG_-The_Chain.mp3.wav	raphiphop
/data0/juliano/homburg/raphiphop/ThunderShop-God_Iz_My_Refuge.mp3.wav	raphiphop
/data0/juliano/homburg/raphiphop/ThunderShop-The_Time_Iz_now.mp3.wav	raphiphop
/data0/juliano/homburg/raphiphop/ThunderShop-We_Dont.mp3.wav	raphiphop
/data0/juliano/homburg/raphiphop/ThunderShop-no_longer.mp3.wav	raphiphop
/data0/juliano/homburg/raphiphop/Titanium_Records-Lifestyle_Of_A_Thug.mp3.wav	raphiphop
/data0/juliano/homburg/raphiphop/Tru_Prophitz-Broken_Man_z_Light.mp3.wav	raphiphop
/data0/juliano/homburg/raphiphop/Truology_All_Starz-Rational_Anthem.mp3.wav	raphiphop
/data0/juliano/homburg/raphiphop/Urban_Sophisticates-Green_Street.mp3.wav	raphiphop
/data0/juliano/homburg/raphiphop/VA_Slim-Mayhem_St_Life_Remix.mp3.wav	raphiphop
/data0/juliano/homburg/raphiphop/VA_Slim-Street_Life.mp3.wav	raphiphop
/data0/juliano/homburg/raphiphop/VA_Slim-The_Game_Wont_Change.mp3.wav	raphiphop
/data0/juliano/homburg/raphiphop/Vision_Entertainment-Hoefessional.mp3.wav	raphiphop
/data0/juliano/homburg/raphiphop/Watt__on-I_m_Late.mp3.wav	raphiphop
/data0/juliano/homburg/raphiphop/Wildchildz-Rain_remix_.mp3.wav	raphiphop
/data0/juliano/homburg/raphiphop/Wizdom_aka_J13-Pollyticken.mp3.wav	raphiphop
/data0/juliano/homburg/raphiphop/Wizdom_aka_J13-Prisoner.mp3.wav	raphiphop
/data0/juliano/homburg/raphiphop/Young_Iz-48_Barz.mp3.wav	raphiphop
/data0/juliano/homburg/raphiphop/Young_Iz-Back_N________.mp3.wav	raphiphop
/data0/juliano/homburg/raphiphop/Young_Iz-Facin____feat__J_Vo_of_Felo_.mp3.wav	raphiphop
/data0/juliano/homburg/raphiphop/blurred_insight-Longer_than_a_Lifetime.mp3.wav	raphiphop
/data0/juliano/homburg/raphiphop/blurred_insight-Taste_the_Shit.mp3.wav	raphiphop
/data0/juliano/homburg/raphiphop/blurred_insight-i_got_love.mp3.wav	raphiphop
/data0/juliano/homburg/raphiphop/child_uncurible-My_Shit.mp3.wav	raphiphop
/data0/juliano/homburg/raphiphop/gebo-Whazup_now__partna__.mp3.wav	raphiphop
/data0/juliano/homburg/raphiphop/jbru-Champion.mp3.wav	raphiphop
/data0/juliano/homburg/raphiphop/jbru-One_of_These_Days.mp3.wav	raphiphop
/data0/juliano/homburg/raphiphop/jbru-Still_Havin_Fun.mp3.wav	raphiphop
/data0/juliano/homburg/raphiphop/jdidda-THE_RISE_OF_THE_PROPHET__IT_S_REAL_.mp3.wav	raphiphop
/data0/juliano/homburg/raphiphop/muddy_waterz-dead_wrong__live_right_.mp3.wav	raphiphop
/data0/juliano/homburg/raphiphop/nonsense_productions-Turbulent_times__Feat___Ced_G___Reese_T.mp3.wav	raphiphop
/data0/juliano/homburg/raphiphop/ruby_redd357-I_Dont_Know_U.mp3.wav	raphiphop
/data0/juliano/homburg/raphiphop/sirus_curse-N_O_S__real_life.mp3.wav	raphiphop
/data0/juliano/homburg/raphiphop/swing_vote-F8I5RE2.mp3.wav	raphiphop
/data0/juliano/homburg/raphiphop/swing_vote-fire.mp3.wav	raphiphop
/data0/juliano/homburg/raphiphop/the_PRODUCT-old_school_b__ch.mp3.wav	raphiphop
/data0/juliano/homburg/raphiphop/treologic-Pass_It_Around.mp3.wav	raphiphop
/data0/juliano/homburg/raphiphop/unified_school_district-EffBeeWrappers.mp3.wav	raphiphop
/data0/juliano/homburg/rock/1nothing-walk_away.mp3.wav	rock
/data0/juliano/homburg/rock/20_20_20_20-Bald_Head.mp3.wav	rock
/data0/juliano/homburg/rock/35R-This_Time.mp3.wav	rock
/data0/juliano/homburg/rock/3QE-CHAOS.mp3.wav	rock
/data0/juliano/homburg/rock/40_watt_domain-Potato.mp3.wav	rock
/data0/juliano/homburg/rock/4TH_PLANE_JAIANT-Idiot.mp3.wav	rock
/data0/juliano/homburg/rock/4TH_PLANE_JAIANT-Let_It_Breathe.mp3.wav	rock
/data0/juliano/homburg/rock/5_Star_Day-Flow.mp3.wav	rock
/data0/juliano/homburg/rock/5_Star_Day-Play_Your_Game.mp3.wav	rock
/data0/juliano/homburg/rock/5_Star_Day-Selfish_Eyes.mp3.wav	rock
/data0/juliano/homburg/rock/AMPSEX-CIRCUS.mp3.wav	rock
/data0/juliano/homburg/rock/ATELLO-Big_Payoff.mp3.wav	rock
/data0/juliano/homburg/rock/A_BRAVE_NEW_WORLD-LIFE.mp3.wav	rock
/data0/juliano/homburg/rock/A__Plus_Attitude-Lara.mp3.wav	rock
/data0/juliano/homburg/rock/After_Bliss-Lay_You_Down.mp3.wav	rock
/data0/juliano/homburg/rock/After_Bliss-Sit_Down_Stare_Out.mp3.wav	rock
/data0/juliano/homburg/rock/Aidy-Jagstang.mp3.wav	rock
/data0/juliano/homburg/rock/All_Access-A_Million_Miles.mp3.wav	rock
/data0/juliano/homburg/rock/All_Access-Baby.mp3.wav	rock
/data0/juliano/homburg/rock/Amateur_Night-Immune.mp3.wav	rock
/data0/juliano/homburg/rock/Amberslam-Twin_Sisters.mp3.wav	rock
/data0/juliano/homburg/rock/Amphibians-Cabone_De_Douanier.mp3.wav	rock
/data0/juliano/homburg/rock/Amphibians-New_Day__I_Feel_Alone_.mp3.wav	rock
/data0/juliano/homburg/rock/Angie_Screams-Trouble.mp3.wav	rock
/data0/juliano/homburg/rock/Animal_Pharm-Superstar.mp3.wav	rock
/data0/juliano/homburg/rock/Animism-Only_What_you_Make_It.mp3.wav	rock
/data0/juliano/homburg/rock/Apple_of_Discord-The_Reward_of_My_Life_Is_An_Angel_Spitting_On_My_S.mp3.wav	rock
/data0/juliano/homburg/rock/April_Sixth-Bring_Me_Down.mp3.wav	rock
/data0/juliano/homburg/rock/Auden_Prim-Living_strong.mp3.wav	rock
/data0/juliano/homburg/rock/Automan-Sleep.mp3.wav	rock
/data0/juliano/homburg/rock/BB_CHUNG_KING_AND_THE_BUDDAHEADS-9_1_1.mp3.wav	rock
/data0/juliano/homburg/rock/BB_CHUNG_KING_AND_THE_BUDDAHEADS-every_now_and_then.mp3.wav	rock
/data0/juliano/homburg/rock/BB_CHUNG_KING_AND_THE_BUDDAHEADS-long_way_down.mp3.wav	rock
/data0/juliano/homburg/rock/BB_CHUNG_KING_AND_THE_BUDDAHEADS-still_the_rain.mp3.wav	rock
/data0/juliano/homburg/rock/BB_CHUNG_KING_AND_THE_BUDDAHEADS-when_the_blues_catch_up_with_you.mp3.wav	rock
/data0/juliano/homburg/rock/BLOWUP-Black_Bones.mp3.wav	rock
/data0/juliano/homburg/rock/BLOWUP-Leave_It_Alone.mp3.wav	rock
/data0/juliano/homburg/rock/BRIDGE_DETROIT_-LETTER_FROM_ELVIS.mp3.wav	rock
/data0/juliano/homburg/rock/Bad_Gravity-Show_Me_The_Love.mp3.wav	rock
/data0/juliano/homburg/rock/Ballyhoo_-_Longshot_.mp3.wav	rock
/data0/juliano/homburg/rock/BammHollow-Dry_As_A_Well.mp3.wav	rock
/data0/juliano/homburg/rock/Bamm_Hollow-In_From_The_Cold.mp3.wav	rock
/data0/juliano/homburg/rock/Banana_Fish_Zero-I_Like_A_Lot.mp3.wav	rock
/data0/juliano/homburg/rock/Barefoot_Hockey_Goalie-Haircut_100.mp3.wav	rock
/data0/juliano/homburg/rock/Battery_Park-B_T_C_.mp3.wav	rock
/data0/juliano/homburg/rock/Beautiful_Nothing-sordinaire.mp3.wav	rock
/data0/juliano/homburg/rock/Bennett_McLaughlin_Band-WANNA_BE_YOUR_MAN.mp3.wav	rock
/data0/juliano/homburg/rock/Big_American_Gurus-I_Just_Want_to_Fall_in_Love.mp3.wav	rock
/data0/juliano/homburg/rock/Bittersweet_Manics-Sarasota.mp3.wav	rock
/data0/juliano/homburg/rock/Blank_White_Page-Hero_Worship.mp3.wav	rock
/data0/juliano/homburg/rock/Bleed-Lies.mp3.wav	rock
/data0/juliano/homburg/rock/Bleed-Sweet_Mary_Jane.mp3.wav	rock
/data0/juliano/homburg/rock/Blinded_By_Zeus-See_Through_You.mp3.wav	rock
/data0/juliano/homburg/rock/BlueRuin-Reflections.mp3.wav	rock
/data0/juliano/homburg/rock/Boneyard-Deadstar.mp3.wav	rock
/data0/juliano/homburg/rock/Brian_Kahanek-Little__Things.mp3.wav	rock
/data0/juliano/homburg/rock/Brian_Thompson_Band-Karnival_Ride.mp3.wav	rock
/data0/juliano/homburg/rock/Brighter_Shade-Time_In_Motion.mp3.wav	rock
/data0/juliano/homburg/rock/Buckfever-Uner_Strain.mp3.wav	rock
/data0/juliano/homburg/rock/BushLeague-Manic.mp3.wav	rock
/data0/juliano/homburg/rock/CODE_58-Moment.mp3.wav	rock
/data0/juliano/homburg/rock/CRUSHED_-Galaxy_Craze.mp3.wav	rock
/data0/juliano/homburg/rock/Caliber-What_We_Are.mp3.wav	rock
/data0/juliano/homburg/rock/Cam_Davis-Place_To_Hide.mp3.wav	rock
/data0/juliano/homburg/rock/Cattywompus-Beautiful.mp3.wav	rock
/data0/juliano/homburg/rock/Celldweller-Symbiont.mp3.wav	rock
/data0/juliano/homburg/rock/Channel_One__band_-Time_to_Live.mp3.wav	rock
/data0/juliano/homburg/rock/Charlie_Street-Feel_Right.mp3.wav	rock
/data0/juliano/homburg/rock/Cherry_Hill-Prelude.mp3.wav	rock
/data0/juliano/homburg/rock/Circle8-Two_Hands.mp3.wav	rock
/data0/juliano/homburg/rock/Circus_Mind-Slow_Start_To_Nowhere.mp3.wav	rock
/data0/juliano/homburg/rock/Civic-Forever_and_a_day__Surpise_.mp3.wav	rock
/data0/juliano/homburg/rock/Clay_Sun_Union-Another_World.mp3.wav	rock
/data0/juliano/homburg/rock/Clay_Sun_Union-Floating_On_Lead.mp3.wav	rock
/data0/juliano/homburg/rock/Clay_Sun_Union-When_You_Look_To_The_Sky.mp3.wav	rock
/data0/juliano/homburg/rock/Clinton_James-Everything__Somehow_.mp3.wav	rock
/data0/juliano/homburg/rock/Clone_Theory-river.mp3.wav	rock
/data0/juliano/homburg/rock/Cloned_1-Now_the_After.mp3.wav	rock
/data0/juliano/homburg/rock/Club_Deluxe-Plastic_Jesus.mp3.wav	rock
/data0/juliano/homburg/rock/Common_Ground__Hip_Hop_funk_Rock_-This_Shot.mp3.wav	rock
/data0/juliano/homburg/rock/Common_Thrill-Whiskey_Glow.mp3.wav	rock
/data0/juliano/homburg/rock/Complete-A_Poet_s_Suicide.mp3.wav	rock
/data0/juliano/homburg/rock/Conditioned_Response-Deep_Inside.mp3.wav	rock
/data0/juliano/homburg/rock/Confidence_Man-Lantern_Jaw.mp3.wav	rock
/data0/juliano/homburg/rock/Coping_With_Ignorance-Plastic_Fixation.mp3.wav	rock
/data0/juliano/homburg/rock/Coping_With_Ignorance-Shattered_Dreams.mp3.wav	rock
/data0/juliano/homburg/rock/Counterbalance-Only_Son.mp3.wav	rock
/data0/juliano/homburg/rock/Crave-Not_Alone.mp3.wav	rock
/data0/juliano/homburg/rock/Creature_of_Mercy-Blame.mp3.wav	rock
/data0/juliano/homburg/rock/Creature_of_Mercy-Love_Sick.mp3.wav	rock
/data0/juliano/homburg/rock/Cycle_of_Pain-Somebody_Stop_Me.mp3.wav	rock
/data0/juliano/homburg/rock/DC_3-Everybody_s_Going_Down_to_the_Rave.mp3.wav	rock
/data0/juliano/homburg/rock/DOSE_-I_DON_T_BELIEVE_IN_YOU.mp3.wav	rock
/data0/juliano/homburg/rock/Damage__from_OC__-What_is.mp3.wav	rock
/data0/juliano/homburg/rock/Dana_Osborn-Spanish_Love.mp3.wav	rock
/data0/juliano/homburg/rock/David_Matthews-Ready_or_Not.mp3.wav	rock
/data0/juliano/homburg/rock/Dead_City_Sunday-Taking_Back_What_s_Left.mp3.wav	rock
/data0/juliano/homburg/rock/Deborah_Dalton-Brother_s_Keeper.mp3.wav	rock
/data0/juliano/homburg/rock/Denied_By_Distance-Looking_at_You.mp3.wav	rock
/data0/juliano/homburg/rock/Deridian-Matchsticks___Lovers__don_t_go_together_.mp3.wav	rock
/data0/juliano/homburg/rock/DirtNap-Bad_Mood.mp3.wav	rock
/data0/juliano/homburg/rock/Dopamine-Blind_to_me.mp3.wav	rock
/data0/juliano/homburg/rock/Doteen-Arrow_to_the_Sun.mp3.wav	rock
/data0/juliano/homburg/rock/DownLo-Indecision.mp3.wav	rock
/data0/juliano/homburg/rock/Drew_Young_and_the_Henchman-Fury.mp3.wav	rock
/data0/juliano/homburg/rock/Drop_Out-On_My_Way.mp3.wav	rock
/data0/juliano/homburg/rock/Drunk_Stuntmen-Downtown_Boys.mp3.wav	rock
/data0/juliano/homburg/rock/Dynaride-Fold.mp3.wav	rock
/data0/juliano/homburg/rock/Dynaride-Interesting.mp3.wav	rock
/data0/juliano/homburg/rock/EBO-Rain_Song.mp3.wav	rock
/data0/juliano/homburg/rock/EBO-Tragic.mp3.wav	rock
/data0/juliano/homburg/rock/Ehren_Ebbage-I_m_Not_Sorry.mp3.wav	rock
/data0/juliano/homburg/rock/Elektrik_Motorfish-Fish_Outta_Watta.mp3.wav	rock
/data0/juliano/homburg/rock/Element57-Woke_Up_Late.mp3.wav	rock
/data0/juliano/homburg/rock/Emery_Vesch-A_Mile_Away.mp3.wav	rock
/data0/juliano/homburg/rock/Enjoy_Aurora-Fader.mp3.wav	rock
/data0/juliano/homburg/rock/Erotic_Suicide-Breakin_Down.mp3.wav	rock
/data0/juliano/homburg/rock/Even_The_Odd-Forgive_Me.mp3.wav	rock
/data0/juliano/homburg/rock/FADE-Distracted.mp3.wav	rock
/data0/juliano/homburg/rock/FAR_CRY-Watch_my_heart_disappear_in_the_sky.mp3.wav	rock
/data0/juliano/homburg/rock/FTC-Fly.mp3.wav	rock
/data0/juliano/homburg/rock/Fabio_Matador-Define_your_time.mp3.wav	rock
/data0/juliano/homburg/rock/Faceles-Falling_Down.mp3.wav	rock
/data0/juliano/homburg/rock/Fear_Makes_Perfect-Trip___Slide.mp3.wav	rock
/data0/juliano/homburg/rock/Fiercely_Me-Gunstash.mp3.wav	rock
/data0/juliano/homburg/rock/Fifth_Letter-Breathe_Out.mp3.wav	rock
/data0/juliano/homburg/rock/Fine_for_Now-Second_coming.mp3.wav	rock
/data0/juliano/homburg/rock/Finned_Pilot-Far_Away.mp3.wav	rock
/data0/juliano/homburg/rock/First_Time_Fallen-Forever_And_A_Day.mp3.wav	rock
/data0/juliano/homburg/rock/Fishbelly_White-Way_Too_Long_MW.mp3.wav	rock
/data0/juliano/homburg/rock/Five_to_the_Face-Pain_Inside.mp3.wav	rock
/data0/juliano/homburg/rock/Flat_Stanley-Money.mp3.wav	rock
/data0/juliano/homburg/rock/Flood_Ritual-Touch_My_Soul.mp3.wav	rock
/data0/juliano/homburg/rock/Floodgate___Christian_Rock_-Shape_Me.mp3.wav	rock
/data0/juliano/homburg/rock/Frank_Einstein-Pull_My_Strings.mp3.wav	rock
/data0/juliano/homburg/rock/Fred_Wilson-Action_Rock___Roll.mp3.wav	rock
/data0/juliano/homburg/rock/FullBluntControl-Spaceship.mp3.wav	rock
/data0/juliano/homburg/rock/Fulyn_Derane-There_will_come_a_Day_.mp3.wav	rock
/data0/juliano/homburg/rock/Funk_Shway-Cool_for_the_Moment.mp3.wav	rock
/data0/juliano/homburg/rock/Gang_of_Creeps-Psychobitchstalkerchick.mp3.wav	rock
/data0/juliano/homburg/rock/Gilmore-Nothing.mp3.wav	rock
/data0/juliano/homburg/rock/Gin_Road-Empty_Room.mp3.wav	rock
/data0/juliano/homburg/rock/Gin_Road-Where_is_my_brother_.mp3.wav	rock
/data0/juliano/homburg/rock/Glenn_Lyse-guilty.mp3.wav	rock
/data0/juliano/homburg/rock/Gods_Made_Love-Freakshow.mp3.wav	rock
/data0/juliano/homburg/rock/GordonGartrell-A_New_Song.mp3.wav	rock
/data0/juliano/homburg/rock/Grant_Langston-The_Real_Man.mp3.wav	rock
/data0/juliano/homburg/rock/Guernica_Havoc-The_Leading_Spiral_to_Nowhere.mp3.wav	rock
/data0/juliano/homburg/rock/Guinness_Clarke_s_Wine-Another_Time__Another_Place.mp3.wav	rock
/data0/juliano/homburg/rock/Guinness_Clarke_s_Wine-Perfect.mp3.wav	rock
/data0/juliano/homburg/rock/HIT_THE_GROUND_RUNNIN___CRYSTAL_ROXX-Got_No_Time.mp3.wav	rock
/data0/juliano/homburg/rock/HOLLOW_dallas-Bleed_Me_Slow.mp3.wav	rock
/data0/juliano/homburg/rock/Half_Zaftig-Firefly.mp3.wav	rock
/data0/juliano/homburg/rock/Hanover_Fist-Waiting.mp3.wav	rock
/data0/juliano/homburg/rock/Harrison-Choke.mp3.wav	rock
/data0/juliano/homburg/rock/Harrison-Cool_New_One.mp3.wav	rock
/data0/juliano/homburg/rock/Head-Icicle.mp3.wav	rock
/data0/juliano/homburg/rock/Heydevils-Jezebel.mp3.wav	rock
/data0/juliano/homburg/rock/Honeybox-Breathe.mp3.wav	rock
/data0/juliano/homburg/rock/HorseRocks-Fall.mp3.wav	rock
/data0/juliano/homburg/rock/In_Fervor-Hammer_Song.mp3.wav	rock
/data0/juliano/homburg/rock/In_Itself-Defined.mp3.wav	rock
/data0/juliano/homburg/rock/Instant_Winner_WA-In_Words.mp3.wav	rock
/data0/juliano/homburg/rock/Its_Revenge-These_Times.mp3.wav	rock
/data0/juliano/homburg/rock/JEFF_ALLAN-THE_MONKEY.mp3.wav	rock
/data0/juliano/homburg/rock/JEL-Suburban_Legend.mp3.wav	rock
/data0/juliano/homburg/rock/JIVE_5_u_s_-Swarm.mp3.wav	rock
/data0/juliano/homburg/rock/JaD____jade___-Lose_Your_Mind.mp3.wav	rock
/data0/juliano/homburg/rock/Jack_Butler_Band-Hole_in_My_Mind.mp3.wav	rock
/data0/juliano/homburg/rock/Jack___Present_Co_-Doctor.mp3.wav	rock
/data0/juliano/homburg/rock/Jake-Evil.mp3.wav	rock
/data0/juliano/homburg/rock/Jake-Standing_Still.mp3.wav	rock
/data0/juliano/homburg/rock/James_Katz-she_s_having_a_bender.mp3.wav	rock
/data0/juliano/homburg/rock/JayCrash-Ask_Me_Why.mp3.wav	rock
/data0/juliano/homburg/rock/JayCrash-Ridin_That_Wave.mp3.wav	rock
/data0/juliano/homburg/rock/Jeffery_Sez-Plastic_And_Pills.mp3.wav	rock
/data0/juliano/homburg/rock/Jesse_Johnson-Pass_the_Chips.mp3.wav	rock
/data0/juliano/homburg/rock/Jive_5-dozer.mp3.wav	rock
/data0/juliano/homburg/rock/Johnny_Young-If_I.mp3.wav	rock
/data0/juliano/homburg/rock/Jonathan_Casey-My_Mistake.mp3.wav	rock
/data0/juliano/homburg/rock/Jordan_Doucette-Screw_You.mp3.wav	rock
/data0/juliano/homburg/rock/Josh_Holmes_Band-endure.mp3.wav	rock
/data0/juliano/homburg/rock/KarmaCycle-Drown.mp3.wav	rock
/data0/juliano/homburg/rock/Kate_Dovelyn_Band-Flesh___Bone.mp3.wav	rock
/data0/juliano/homburg/rock/Kate_Dovelyn_Band-Lullaby.mp3.wav	rock
/data0/juliano/homburg/rock/Ketracel_White-Second_Look.mp3.wav	rock
/data0/juliano/homburg/rock/Kettle_of_Fish-Let_Love_Go.mp3.wav	rock
/data0/juliano/homburg/rock/Kinetic_Output-Dancing_Round_The_Millionaire.mp3.wav	rock
/data0/juliano/homburg/rock/Kinetic_Output-Deal_With_It.mp3.wav	rock
/data0/juliano/homburg/rock/Kuma-Everygirl.mp3.wav	rock
/data0/juliano/homburg/rock/LOUDLOVE-Diamond_In_The_Rough.mp3.wav	rock
/data0/juliano/homburg/rock/LOUDLOVE-Meatcage.mp3.wav	rock
/data0/juliano/homburg/rock/Last_Generation-My_Brother.mp3.wav	rock
/data0/juliano/homburg/rock/Last_Year_Portrait-Anything_Left.mp3.wav	rock
/data0/juliano/homburg/rock/LaughingColors-American_Boy.mp3.wav	rock
/data0/juliano/homburg/rock/LaughingColors-War_On_Drugs.mp3.wav	rock
/data0/juliano/homburg/rock/Lean-Hope_For_Better.mp3.wav	rock
/data0/juliano/homburg/rock/Lee_Farmer_Band-Tearin__through_my_heart___Farmer_Prowse.mp3.wav	rock
/data0/juliano/homburg/rock/Life_of_Riley__dallas_-Thursday_Afternoon.mp3.wav	rock
/data0/juliano/homburg/rock/Lifelike-Machinery.mp3.wav	rock
/data0/juliano/homburg/rock/Lifted______NY_-One_Man_Show.mp3.wav	rock
/data0/juliano/homburg/rock/Lion_Sun_Dog-Phantom_Power.mp3.wav	rock
/data0/juliano/homburg/rock/Little_Joe_Pinto-Sound_Check.mp3.wav	rock
/data0/juliano/homburg/rock/Livin_stone-Sweet_Manners.mp3.wav	rock
/data0/juliano/homburg/rock/Lodos-too_late.mp3.wav	rock
/data0/juliano/homburg/rock/Long_Distance_Call-Talkin__California.mp3.wav	rock
/data0/juliano/homburg/rock/Longfellow-The_Time_It_Takes_To_Kill_A_Man_is_Life.mp3.wav	rock
/data0/juliano/homburg/rock/Lost_Anthem___Indiana_-Too_Far_Gone.mp3.wav	rock
/data0/juliano/homburg/rock/Lucid_Fly-Collide.mp3.wav	rock
/data0/juliano/homburg/rock/Lume-Deconstruct_me.mp3.wav	rock
/data0/juliano/homburg/rock/MICHAEL_LOGEN-Goin__Home.mp3.wav	rock
/data0/juliano/homburg/rock/MWK-Godspeed.mp3.wav	rock
/data0/juliano/homburg/rock/Mama_s_Gravy-A_Dollar_Away.mp3.wav	rock
/data0/juliano/homburg/rock/Man_Made_God-Juice__Gimme__some_.mp3.wav	rock
/data0/juliano/homburg/rock/Man_Made_Monster-Luzer.mp3.wav	rock
/data0/juliano/homburg/rock/Mankind-Down.mp3.wav	rock
/data0/juliano/homburg/rock/Marshall_Tully-Bail.mp3.wav	rock
/data0/juliano/homburg/rock/Matthew_James_Band-Vagabond_Girl.mp3.wav	rock
/data0/juliano/homburg/rock/Mean_Flower-The_Innocent.mp3.wav	rock
/data0/juliano/homburg/rock/Merit-Locked_from_the_Inside.mp3.wav	rock
/data0/juliano/homburg/rock/MikeConde-freefallen.mp3.wav	rock
/data0/juliano/homburg/rock/Mike_Borgia-Right_Away.mp3.wav	rock
/data0/juliano/homburg/rock/MindCandy-Energy.mp3.wav	rock
/data0/juliano/homburg/rock/MindCandy-Interactive_X.mp3.wav	rock
/data0/juliano/homburg/rock/MindCandy-Twenty_One.mp3.wav	rock
/data0/juliano/homburg/rock/Mister_Vertigo-Falter.mp3.wav	rock
/data0/juliano/homburg/rock/MotherofPearl-Myself.mp3.wav	rock
/data0/juliano/homburg/rock/Mothers_Buzz-Fortynine.mp3.wav	rock
/data0/juliano/homburg/rock/Motor_City_Creeps-If_my_life_was_a_book___.mp3.wav	rock
/data0/juliano/homburg/rock/MudSplash-Mile_Away.mp3.wav	rock
/data0/juliano/homburg/rock/Musket_Rumble-Rock_n__Roll_is_the_Medicine.mp3.wav	rock
/data0/juliano/homburg/rock/Muzzy_Luctin-River.mp3.wav	rock
/data0/juliano/homburg/rock/NEVERSAY-Saboteur.mp3.wav	rock
/data0/juliano/homburg/rock/NGB-Cold2.mp3.wav	rock
/data0/juliano/homburg/rock/NOW_U_KNOW-OBSESSION.mp3.wav	rock
/data0/juliano/homburg/rock/NUMM___Rochester_NY_-Swim_Free__Radio_Debut_.mp3.wav	rock
/data0/juliano/homburg/rock/Naked_Spatula_Monkeys__NSM_-Mind.mp3.wav	rock
/data0/juliano/homburg/rock/Nectar__Canada_-Red_Sands.mp3.wav	rock
/data0/juliano/homburg/rock/Neon_Thrills-Two_Cigarettes.mp3.wav	rock
/data0/juliano/homburg/rock/Neon_Thrills-Your_Unfunny_Joke.mp3.wav	rock
/data0/juliano/homburg/rock/New_Granada-Just_Wave.mp3.wav	rock
/data0/juliano/homburg/rock/New_Season-Common_sense.mp3.wav	rock
/data0/juliano/homburg/rock/New_World_Relampagos-El_Arlequin_Del_Toledo.mp3.wav	rock
/data0/juliano/homburg/rock/Next_In_Line-Bye_Polar.mp3.wav	rock
/data0/juliano/homburg/rock/Next_In_Line-Guesstimate.mp3.wav	rock
/data0/juliano/homburg/rock/Nicola-Mary.mp3.wav	rock
/data0/juliano/homburg/rock/Nightheart-Stoned_Shitless.mp3.wav	rock
/data0/juliano/homburg/rock/NineHead-Guaranteed.mp3.wav	rock
/data0/juliano/homburg/rock/Nitro_Lounge-Close_to_the_Water.mp3.wav	rock
/data0/juliano/homburg/rock/No_Mas-Make_Up_Your_Mind.mp3.wav	rock
/data0/juliano/homburg/rock/Normalcy-She_Paints.mp3.wav	rock
/data0/juliano/homburg/rock/Nothing_More-sad_eyes.mp3.wav	rock
/data0/juliano/homburg/rock/Nova_Clutch-forget_becoming_real__demo_.mp3.wav	rock
/data0/juliano/homburg/rock/Obsessive_Compulsive-Perfect_Wreck.mp3.wav	rock
/data0/juliano/homburg/rock/One_Trick_Pony-Games.mp3.wav	rock
/data0/juliano/homburg/rock/Orizon-Who_Needs_Air.mp3.wav	rock
/data0/juliano/homburg/rock/Osiris__orlando_-Secret_Lies.mp3.wav	rock
/data0/juliano/homburg/rock/Outshine-Promise.mp3.wav	rock
/data0/juliano/homburg/rock/Outshine-Running_Away.mp3.wav	rock
/data0/juliano/homburg/rock/Overtone__Chicago-Shattered.mp3.wav	rock
/data0/juliano/homburg/rock/PAJAMAZON-Baby_Tee.mp3.wav	rock
/data0/juliano/homburg/rock/PROMKING-New_Plane.mp3.wav	rock
/data0/juliano/homburg/rock/PULL-selfish.mp3.wav	rock
/data0/juliano/homburg/rock/Patrick_Conway-Everything_I_Know.mp3.wav	rock
/data0/juliano/homburg/rock/Peeler-Half_Past_High.mp3.wav	rock
/data0/juliano/homburg/rock/Penny_Dreadful-Merry_Andrew.mp3.wav	rock
/data0/juliano/homburg/rock/Persona-Friend___Enemy.mp3.wav	rock
/data0/juliano/homburg/rock/Philpot-Drips.mp3.wav	rock
/data0/juliano/homburg/rock/Planet_12-Stay_At_Home.mp3.wav	rock
/data0/juliano/homburg/rock/Porter-Resurrection.mp3.wav	rock
/data0/juliano/homburg/rock/Premonition___RI-My_Best_For_You.mp3.wav	rock
/data0/juliano/homburg/rock/Premonition___RI-Suffer.mp3.wav	rock
/data0/juliano/homburg/rock/Punching_Judy-Kiss_it_Goodbye.mp3.wav	rock
/data0/juliano/homburg/rock/QUALONE-Insanity_Ride.mp3.wav	rock
/data0/juliano/homburg/rock/QUALONE-Mind_Cloud.mp3.wav	rock
/data0/juliano/homburg/rock/Quaker_Gun-Lady_Luck.mp3.wav	rock
/data0/juliano/homburg/rock/RASA-Short_Circuit.mp3.wav	rock
/data0/juliano/homburg/rock/Rainside-Eleven.mp3.wav	rock
/data0/juliano/homburg/rock/Rapscallion-Small_Apartment.mp3.wav	rock
/data0/juliano/homburg/rock/Reason_For_Leaving-Blown.mp3.wav	rock
/data0/juliano/homburg/rock/Rebel_Storm-Takin_All_I_Can.mp3.wav	rock
/data0/juliano/homburg/rock/RedShift_Project-Desert_Song.mp3.wav	rock
/data0/juliano/homburg/rock/Red_McFunk-Simple__Wise___Wicked.mp3.wav	rock
/data0/juliano/homburg/rock/Redneck_Rolemodels-What_s_Inside.mp3.wav	rock
/data0/juliano/homburg/rock/Remnant_Gathering-Samaritan.mp3.wav	rock
/data0/juliano/homburg/rock/Ridalyn-She_Says_Goodbye.mp3.wav	rock
/data0/juliano/homburg/rock/Rik_Cardiff-She_s_so____pre_prod__demo.mp3.wav	rock
/data0/juliano/homburg/rock/Road_Trip-Alright.mp3.wav	rock
/data0/juliano/homburg/rock/Road_Trip-Crazy_Feeling.mp3.wav	rock
/data0/juliano/homburg/rock/Rob_Russell___The_Sore_Losers-Less_Like_You.mp3.wav	rock
/data0/juliano/homburg/rock/Rotation-Someone_else_s_life.mp3.wav	rock
/data0/juliano/homburg/rock/Rotation-Where_did_you_go_.mp3.wav	rock
/data0/juliano/homburg/rock/Royal_Bliss-Busy_Bee.mp3.wav	rock
/data0/juliano/homburg/rock/Royal_Crush-strange.mp3.wav	rock
/data0/juliano/homburg/rock/Rubberman-Send_Love.mp3.wav	rock
/data0/juliano/homburg/rock/Rune-Beautiful_Deadly.mp3.wav	rock
/data0/juliano/homburg/rock/Rune-Paradise.mp3.wav	rock
/data0/juliano/homburg/rock/RunnerUp-Less_Than_three.mp3.wav	rock
/data0/juliano/homburg/rock/Ryan5-one_more_day.mp3.wav	rock
/data0/juliano/homburg/rock/SHUNT-AWAY.mp3.wav	rock
/data0/juliano/homburg/rock/SONICRUSH-Shine_On_Me.mp3.wav	rock
/data0/juliano/homburg/rock/SPOKE-When_I_Fall_demo_.mp3.wav	rock
/data0/juliano/homburg/rock/SQUAD_51-In_Memory_Of___.mp3.wav	rock
/data0/juliano/homburg/rock/SQUAD_51-Rainman.mp3.wav	rock
/data0/juliano/homburg/rock/SQUAD_51-Standing_Still.mp3.wav	rock
/data0/juliano/homburg/rock/ST0RM-Paper__Rock__Scissors.mp3.wav	rock
/data0/juliano/homburg/rock/SWIFTHOLLY-Cancer.mp3.wav	rock
/data0/juliano/homburg/rock/Safety-Pictures_in_Motion.mp3.wav	rock
/data0/juliano/homburg/rock/Sammy_s_Good_Eye-MAKE_ME_SUPER.mp3.wav	rock
/data0/juliano/homburg/rock/Sammy_s_Good_Eye-My_Ma_Said.mp3.wav	rock
/data0/juliano/homburg/rock/Scott_Sudbury-Here_I_Go.mp3.wav	rock
/data0/juliano/homburg/rock/Scott_Sudbury-It_Must_Be_You__Ardent_Mix_.mp3.wav	rock
/data0/juliano/homburg/rock/Scream_Sophie-Everyday.mp3.wav	rock
/data0/juliano/homburg/rock/Seano_Barry-Replica.mp3.wav	rock
/data0/juliano/homburg/rock/Second_NaturePortland-Grey.mp3.wav	rock
/data0/juliano/homburg/rock/Seconds_Before-Heart_Of_Concrete.mp3.wav	rock
/data0/juliano/homburg/rock/Secret_Suburbia-I_ve_Been_Around.mp3.wav	rock
/data0/juliano/homburg/rock/Section_8_USA_-Highland_Road.mp3.wav	rock
/data0/juliano/homburg/rock/Semidivine-Sticks_and_Stones.mp3.wav	rock
/data0/juliano/homburg/rock/Settlement-No_Tomorrow.mp3.wav	rock
/data0/juliano/homburg/rock/Seven_Secrets-Forever_Till_Now.mp3.wav	rock
/data0/juliano/homburg/rock/Severence-Reflection.mp3.wav	rock
/data0/juliano/homburg/rock/Shallow-Bleed.mp3.wav	rock
/data0/juliano/homburg/rock/Sheldon_Rourke___the_Cold_Hearts_-Falling_Apart.mp3.wav	rock
/data0/juliano/homburg/rock/Shonuff-Outcast.mp3.wav	rock
/data0/juliano/homburg/rock/Shonuff-What_Goes_Around.mp3.wav	rock
/data0/juliano/homburg/rock/Sick_Speed-The_Test.mp3.wav	rock
/data0/juliano/homburg/rock/Signalflow-The_Need.mp3.wav	rock
/data0/juliano/homburg/rock/Sittser-Losing_My_Fear_of_Heights.mp3.wav	rock
/data0/juliano/homburg/rock/Sketchbook_for_Eris-The_Center_Lines.mp3.wav	rock
/data0/juliano/homburg/rock/Skincell-Silver_cord.mp3.wav	rock
/data0/juliano/homburg/rock/Slack__TN_-This_Had_Better_Be_Good.mp3.wav	rock
/data0/juliano/homburg/rock/Sleep_Station-Frustration_of_Leaving.mp3.wav	rock
/data0/juliano/homburg/rock/Sly_Willie_Down-The_Hippie_Song.mp3.wav	rock
/data0/juliano/homburg/rock/Soap__Chicago__IL_-Creepy_Song.mp3.wav	rock
/data0/juliano/homburg/rock/Somebody_s_Mother-Linger.mp3.wav	rock
/data0/juliano/homburg/rock/SonicBlonde-All_In_My_Head.mp3.wav	rock
/data0/juliano/homburg/rock/Sonicvision-Ghost.mp3.wav	rock
/data0/juliano/homburg/rock/SoulThieves-Confess.mp3.wav	rock
/data0/juliano/homburg/rock/South_Normal-Ariel.mp3.wav	rock
/data0/juliano/homburg/rock/South_Normal-Shakin_.mp3.wav	rock
/data0/juliano/homburg/rock/South_Normal-White_Lies.mp3.wav	rock
/data0/juliano/homburg/rock/South_Normal-the_Optimist.mp3.wav	rock
/data0/juliano/homburg/rock/Sparkplug-Drop_Out_.mp3.wav	rock
/data0/juliano/homburg/rock/Spiritfall-Without_Words.mp3.wav	rock
/data0/juliano/homburg/rock/Splitfinger-Silvercloud.mp3.wav	rock
/data0/juliano/homburg/rock/Square_the_Circle-comatose.mp3.wav	rock
/data0/juliano/homburg/rock/Starch-Silk.mp3.wav	rock
/data0/juliano/homburg/rock/Starch-Supercharger.mp3.wav	rock
/data0/juliano/homburg/rock/Starr_Faithfull-This_is_your_life.mp3.wav	rock
/data0/juliano/homburg/rock/Sted_letter-So_Please.mp3.wav	rock
/data0/juliano/homburg/rock/Steelgrass-Good_Trouble.mp3.wav	rock
/data0/juliano/homburg/rock/Strawberry_Bazzare-freak_nut.mp3.wav	rock
/data0/juliano/homburg/rock/Strutmore-Breakdown.mp3.wav	rock
/data0/juliano/homburg/rock/Suntower-Gone_Away.mp3.wav	rock
/data0/juliano/homburg/rock/Super_So_Far-Day_Stealer.mp3.wav	rock
/data0/juliano/homburg/rock/Superimposed4-Hearing_Things.mp3.wav	rock
/data0/juliano/homburg/rock/Supersparkle-All_who_you_know.mp3.wav	rock
/data0/juliano/homburg/rock/Swim-Try_A_Little.mp3.wav	rock
/data0/juliano/homburg/rock/THE_COLOR_RED-SMILE.mp3.wav	rock
/data0/juliano/homburg/rock/THE_LAST_DAYS-television.mp3.wav	rock
/data0/juliano/homburg/rock/THE_NICK_LEE_BAND-Under_The_Influence.mp3.wav	rock
/data0/juliano/homburg/rock/THUNDERFIST-Loud__Fast__Rock_N__Roll.mp3.wav	rock
/data0/juliano/homburg/rock/TOM_Kafafian-Can_t_Change_Me.mp3.wav	rock
/data0/juliano/homburg/rock/Thaxton_Ward-A_World_That_Sleeps.mp3.wav	rock
/data0/juliano/homburg/rock/The_3rd_Degree-Headlights_Past.mp3.wav	rock
/data0/juliano/homburg/rock/The_Accident_Experiment-Mind_Death_Machine.mp3.wav	rock
/data0/juliano/homburg/rock/The_Act-Catalonia.mp3.wav	rock
/data0/juliano/homburg/rock/The_Actual-Cold_Inside.mp3.wav	rock
/data0/juliano/homburg/rock/The_Band_That_Saved_The_World-Industry.mp3.wav	rock
/data0/juliano/homburg/rock/The_Bitterthings-U_R_What_U_Hate.mp3.wav	rock
/data0/juliano/homburg/rock/The_Blast-She_s_gonna_find_out.mp3.wav	rock
/data0/juliano/homburg/rock/The_Boodogs-Over_and_Over.mp3.wav	rock
/data0/juliano/homburg/rock/The_Brite_Side-Brave.mp3.wav	rock
/data0/juliano/homburg/rock/The_Cool_Waters_Band-They_Can_t_Take_It.mp3.wav	rock
/data0/juliano/homburg/rock/The_Corner-Deep_Sleep.mp3.wav	rock
/data0/juliano/homburg/rock/The_Curves-Jojo.mp3.wav	rock
/data0/juliano/homburg/rock/The_Diamond_Club-Mellow_Out.mp3.wav	rock
/data0/juliano/homburg/rock/The_Ditch_Dogs-Southern_Way.mp3.wav	rock
/data0/juliano/homburg/rock/The_End_Game-Piercing.mp3.wav	rock
/data0/juliano/homburg/rock/The_Fine_Line-transparent.mp3.wav	rock
/data0/juliano/homburg/rock/The_GOODING_Band-Slow_Burn__LIVE_.mp3.wav	rock
/data0/juliano/homburg/rock/The_Genuine_Leather_Band-Bitch_Blues.mp3.wav	rock
/data0/juliano/homburg/rock/The_Industry-The_Exception_To_The_Rule.mp3.wav	rock
/data0/juliano/homburg/rock/The_Influence-Givin__Up_The_Ghost.mp3.wav	rock
/data0/juliano/homburg/rock/The_Love_Supreme-Careful_You.mp3.wav	rock
/data0/juliano/homburg/rock/The_Martin_Rivas_Three-Hope.mp3.wav	rock
/data0/juliano/homburg/rock/The_Maxfield_Rabbit-Matters.mp3.wav	rock
/data0/juliano/homburg/rock/The_Mayan_Factor-Warflower.mp3.wav	rock
/data0/juliano/homburg/rock/The_Number_One_Fan-It_s_Happening.mp3.wav	rock
/data0/juliano/homburg/rock/The_Pawn_Rook_Four-Stendhal_Syndrome.mp3.wav	rock
/data0/juliano/homburg/rock/The_People_In__Need_of_Supervision-Are_You_Ready_.mp3.wav	rock
/data0/juliano/homburg/rock/The_Perpetrators-One_More_Day.mp3.wav	rock
/data0/juliano/homburg/rock/The_Quakers-Last_Chance.mp3.wav	rock
/data0/juliano/homburg/rock/The_Quiver_Low-Someone_Else_s_Car.mp3.wav	rock
/data0/juliano/homburg/rock/The_SmashUp_-Dear_Disorder.mp3.wav	rock
/data0/juliano/homburg/rock/The_Station-Goin__Down_Slow.mp3.wav	rock
/data0/juliano/homburg/rock/The_Steepwater_Band-Back_To_The_Bottle.mp3.wav	rock
/data0/juliano/homburg/rock/The_Steepwater_Band-More_Than_a_Good_Thing.mp3.wav	rock
/data0/juliano/homburg/rock/The_Sundogs-Oasis.mp3.wav	rock
/data0/juliano/homburg/rock/The_Unleaded-Revenge__Demo_.mp3.wav	rock
/data0/juliano/homburg/rock/The_Unleaded-Scream_at_the_world__Demo_.mp3.wav	rock
/data0/juliano/homburg/rock/The_Uptown_Rulers-Ride.mp3.wav	rock
/data0/juliano/homburg/rock/The_Wanton-Someday.mp3.wav	rock
/data0/juliano/homburg/rock/The_Will_Wilde_Band-Stop_that_train.mp3.wav	rock
/data0/juliano/homburg/rock/Tommy_Merry-Above_and_beyond.mp3.wav	rock
/data0/juliano/homburg/rock/Trayton-Reality.mp3.wav	rock
/data0/juliano/homburg/rock/Tribe_of_Ben-Leeches.mp3.wav	rock
/data0/juliano/homburg/rock/Trillium-In_This_Machine.mp3.wav	rock
/data0/juliano/homburg/rock/Trip2Go-Drop_Dead_Gorgeous__Rock_.mp3.wav	rock
/data0/juliano/homburg/rock/Trip2Go-Understand.mp3.wav	rock
/data0/juliano/homburg/rock/Trip2Go-Why.mp3.wav	rock
/data0/juliano/homburg/rock/Trippin_on_Dolls-On_Dolls.mp3.wav	rock
/data0/juliano/homburg/rock/Truth_In_Fiction-Hollow.mp3.wav	rock
/data0/juliano/homburg/rock/Tubby-Movin__On.mp3.wav	rock
/data0/juliano/homburg/rock/Tyler_Jorenby-Sleepwalker.mp3.wav	rock
/data0/juliano/homburg/rock/Ultraphonic-Our_World.mp3.wav	rock
/data0/juliano/homburg/rock/Ultravibe-Larayna.mp3.wav	rock
/data0/juliano/homburg/rock/Uncle_Mudfish-Wait_4_Me.mp3.wav	rock
/data0/juliano/homburg/rock/Uncle_Nancy-Where_Are_You_Today_.mp3.wav	rock
/data0/juliano/homburg/rock/Uncle_Slim-Stoned_In_Naples.mp3.wav	rock
/data0/juliano/homburg/rock/Vagabond-Disguised.mp3.wav	rock
/data0/juliano/homburg/rock/Vito_and_the_V_Tones-Got_To_Be.mp3.wav	rock
/data0/juliano/homburg/rock/Walkers_Line-Little_Bit.mp3.wav	rock
/data0/juliano/homburg/rock/We_re_All_Gonna_Die-Loss_And_Shame.mp3.wav	rock
/data0/juliano/homburg/rock/When_Breathing_Stops-Jamie_Leads.mp3.wav	rock
/data0/juliano/homburg/rock/White_Knuckle_Ride-Nobody_Knows.mp3.wav	rock
/data0/juliano/homburg/rock/William_Brooks-Justified.mp3.wav	rock
/data0/juliano/homburg/rock/Winston_Canada-Bottom_Of_The_World.mp3.wav	rock
/data0/juliano/homburg/rock/Wreckage_of_the_Modern_City-thankless_.mp3.wav	rock
/data0/juliano/homburg/rock/Yellow_Five-Fool.mp3.wav	rock
/data0/juliano/homburg/rock/Zipper-Sarah_s_Eyes.mp3.wav	rock
/data0/juliano/homburg/rock/_BROKEN_HALO_-Gagged_And_Bound.mp3.wav	rock
/data0/juliano/homburg/rock/_Isle_Seven_-Through_Your_Hands.mp3.wav	rock
/data0/juliano/homburg/rock/_OMNI_-Paint_by_Numbers.mp3.wav	rock
/data0/juliano/homburg/rock/_OMNI_-Soliloquy.mp3.wav	rock
/data0/juliano/homburg/rock/_REAL-FREE.mp3.wav	rock
/data0/juliano/homburg/rock/__Copper__-Turn.mp3.wav	rock
/data0/juliano/homburg/rock/__Fusion__-Horizon.mp3.wav	rock
/data0/juliano/homburg/rock/__Fusion__-No_Longer_Silent.mp3.wav	rock
/data0/juliano/homburg/rock/__Shoeless_Joe__-Suburbia.mp3.wav	rock
/data0/juliano/homburg/rock/_june_-Cora_Eva_Blue.mp3.wav	rock
/data0/juliano/homburg/rock/alan_smithee-California_Calling.mp3.wav	rock
/data0/juliano/homburg/rock/autoReverse-Home.mp3.wav	rock
/data0/juliano/homburg/rock/betty_in_black-Tell_Somebody.mp3.wav	rock
/data0/juliano/homburg/rock/dean_freeman-Give_Me_Time.mp3.wav	rock
/data0/juliano/homburg/rock/disclaimer-Will_You_Be_There.mp3.wav	rock
/data0/juliano/homburg/rock/drunk_acrobat-creature_feature.mp3.wav	rock
/data0/juliano/homburg/rock/e_so-40_days_in_october.mp3.wav	rock
/data0/juliano/homburg/rock/evelyn_grace-Within_my_Vision.mp3.wav	rock
/data0/juliano/homburg/rock/flood_the_void-Bend.mp3.wav	rock
/data0/juliano/homburg/rock/fragment-CANCER.mp3.wav	rock
/data0/juliano/homburg/rock/gerald_bair-_hanging_out_with_Elvis_.mp3.wav	rock
/data0/juliano/homburg/rock/h_is_orange-right_now.mp3.wav	rock
/data0/juliano/homburg/rock/i_divide-Antifreeze.mp3.wav	rock
/data0/juliano/homburg/rock/janet_theory-Killing_The_Girl__2002_.mp3.wav	rock
/data0/juliano/homburg/rock/jeff_campbell-Southern.mp3.wav	rock
/data0/juliano/homburg/rock/jon_liebing-unbelievably_ugly.mp3.wav	rock
/data0/juliano/homburg/rock/keys_wizard-Into_The_light.mp3.wav	rock
/data0/juliano/homburg/rock/kimberly_kills-Falling_Faster.mp3.wav	rock
/data0/juliano/homburg/rock/kittelstad-Long_Time.mp3.wav	rock
/data0/juliano/homburg/rock/linus__Boston_-On_Your_Own.mp3.wav	rock
/data0/juliano/homburg/rock/majnun-hands_bound.mp3.wav	rock
/data0/juliano/homburg/rock/maladjusted_-Blame.mp3.wav	rock
/data0/juliano/homburg/rock/manicdown-The_Game.mp3.wav	rock
/data0/juliano/homburg/rock/mona-Under_Again.mp3.wav	rock
/data0/juliano/homburg/rock/mona-angels.mp3.wav	rock
/data0/juliano/homburg/rock/monday_morning-Vanity.mp3.wav	rock
/data0/juliano/homburg/rock/morris_minors-grandeur.mp3.wav	rock
/data0/juliano/homburg/rock/nanastreak-Come_Back_Down.mp3.wav	rock
/data0/juliano/homburg/rock/narteke-solitude.mp3.wav	rock
/data0/juliano/homburg/rock/nero-Lost_Highway.mp3.wav	rock
/data0/juliano/homburg/rock/one_life-she_came_to_me.mp3.wav	rock
/data0/juliano/homburg/rock/one_perfect_minute-Inside_Of_You.mp3.wav	rock
/data0/juliano/homburg/rock/orbis-Launch.mp3.wav	rock
/data0/juliano/homburg/rock/paper_street_saints-Break_me_in.mp3.wav	rock
/data0/juliano/homburg/rock/plato_s_halo-In_the_Pink.mp3.wav	rock
/data0/juliano/homburg/rock/pretendgirlfriend-Its_not_the_end_of_the_world.mp3.wav	rock
/data0/juliano/homburg/rock/retrograde-Caught_in_the_Sun.mp3.wav	rock
/data0/juliano/homburg/rock/retrograde-Complicated.mp3.wav	rock
/data0/juliano/homburg/rock/retrograde-Letting_Go.mp3.wav	rock
/data0/juliano/homburg/rock/riding_mercury-hey_dreamer.mp3.wav	rock
/data0/juliano/homburg/rock/shedd-Slide.mp3.wav	rock
/data0/juliano/homburg/rock/skratch_-Mary__Rock_.mp3.wav	rock
/data0/juliano/homburg/rock/spacejunk-One_Unstable_Mind.mp3.wav	rock
/data0/juliano/homburg/rock/spike_speedwrench-Don_t_Follow_Me.mp3.wav	rock
/data0/juliano/homburg/rock/sputnik_monroe-shamu_suicide.mp3.wav	rock
/data0/juliano/homburg/rock/starving_friday-Borrow.mp3.wav	rock
/data0/juliano/homburg/rock/stonepark-Carpe_diem.mp3.wav	rock
/data0/juliano/homburg/rock/strangegirl-should_i_stay.mp3.wav	rock
/data0/juliano/homburg/rock/superjuice__new_york_city_-humble_state.mp3.wav	rock
/data0/juliano/homburg/rock/supermint-What_s_Going_On.mp3.wav	rock
/data0/juliano/homburg/rock/ten2nine-Smoke_In_The_Light.mp3.wav	rock
/data0/juliano/homburg/rock/tentilfour-We_Are_One.mp3.wav	rock
/data0/juliano/homburg/rock/tex-How_This_World_Turns.mp3.wav	rock
/data0/juliano/homburg/rock/the_Golords-The_Return_of_the_C_T_s.mp3.wav	rock
/data0/juliano/homburg/rock/the_devilheads-like_you_better_drunk.mp3.wav	rock
/data0/juliano/homburg/rock/the_morgansterns-In_Your_Head.mp3.wav	rock
/data0/juliano/homburg/rock/the_morgansterns-Look_at_Me.mp3.wav	rock
/data0/juliano/homburg/rock/thirdmanout-the_edge_of_the_knife.mp3.wav	rock
/data0/juliano/homburg/rock/truesetto-silent_treatment.mp3.wav	rock
/data0/juliano/homburg/rock/xEndeveRx-Break_my_Fall.mp3.wav	rock
/data0/juliano/homburg/rock/zamora_ca_-bent_spoon_black.mp3.wav	rock
/data0/juliano/homburg/rock/zerostar-We_Will_Fight.mp3.wav	rock
